*** 유의어 - Synonyms (/course/634971/ebs-topik-ii-intermediateadvanced-vocabulary/1/)
가리키다	일컫다
가슴이 부풀다	기대에 가득 차다
간신히	겨우
갈다	바꾸다
개다	접다
거의	대부분
겨우	고작 / 불과
겪다	경험하다
견디다	참다 / 버티다
결심하다	마음을 먹다 / 마음을 정하다
계속	끊임없이
고생을 하다	애를 먹다
고치다	수리하다 / 수선하다
곤란하다 1	어렵다 / 힘들다
곤란하다 2	난처하다 / 난감하다
그다지	그렇게까지
그만두다	포기하다
그지없다	이루 다 말할 수 없다
극복하다	이기다
기르다	키우다
기억에서 사라지다	잊어버리다
꼬이다	얽히다
꼭	반드시 / 어김없이 / 틀림없이
꾸다	빌리다
끊다	자르다
끌다	당기다
나 몰라라 하다	외면하다 / 못 본 체하다
나르다	옮기다
나쁘다	해롭다
낯익다	전에 몇 번 보다
넉넉하다	여유 있다
노력하다	애를 쓰다
눈감아 버리다	모르는 척하다
느끼다 1	깨닫다 / 절감하다
느끼다 2	통감하다 / 실감하다
단장하다	꾸미다 / 가꾸다
대강	대충
대하다	관하다
덮어놓다	무턱대다
동일하다	같다
드디어	마침내
드물다	귀하다
뚜렷하다	분명하다
마찬가지로	똑같이
맡다	담당하다
머뭇거리다	주저하다 / 망설이다
무승부를 기록하다	비기다
미루다	연기하다
밑지다	손해를 보다
바삐 움직이고 있다	서두르고 있다
발생하다	생기다 / 일어나다
밝혀내다	규명하다 / 드러내다
번갈아	교대로
번지다	확산되다 / 퍼지다
벗기다	까다
벗어나다	극복하다 / 탈피하다
보호하다	지키다
복잡하다	붐비다
부족하다	모자라다
비롯되다	시작되다
뽑다	고르다
사고하다	생각하다
사라지다	없어지다
사정이 안 좋다	형편이 어렵다
삽시간에	순식간에
생각조차 못 하다	엄두를 못 내다
(상대방을) 생각하다	배려하다
성취 가능하다	이룰 수 있다
성취하다	이루다 / 성공하다
쇄도하다	빗발치다
수월하다	손쉽다
안심하다	마음을 놓다
알뜰하다	(돈을) 아껴 쓰다
어깨가 무겁다	부담이 되다
어색하다	서먹하다
어안이 벙벙하다	어리둥절하다
피할 수 없다	불가피하다
연연하다	집착하다
원수를 갚다	보복하다 / 복수하다
의기소침하다	풀이 죽다
잘 듣다	효과가 있다
전망이 밝다	앞날이 희망적이다
절약하다	아끼다
제외하다	빼다
주도하다	이끌다
증가하다	늘어나다 / 많아지다
집다	잡다
쩔쩔매다	꼼짝 못하다
찜찜하다	꺼림칙하다
철저하다	철두철미하다 / 투철하다
치우다	정리하다
팔리다	매진되다
한산하다	한적하다
함유하다	포함하다
(긴장을) 해소하다	풀다
확인하다	검토하다
휘말리다	휩싸이다
흔하다	많다
*** 다의어 - Polysemy (/course/634971/ebs-topik-ii-intermediateadvanced-vocabulary/2/)
가리다	1) cover, conceal 2) determine 3) select only what you like
거두다	1) stop 2) harvest,gather 3) score a victory 
걸다	1) to hang sth 2) be impatient,make an action first 3) make a phonecall
걸리다	1) get caught 2) get stuck somewhere 3) catch a disease 
고치다	1) repair sth 2) get better (when sick) 3) correct sth
깎다	1) peel,sharpen 2) cut, trim, clip, shave 3) reduce (price)
꺾이다	1) break, snap 2) be folded 3) turn, curve
꾸다	1) to dream 2) to have a dream/desire 3) to borrow (money)
끌다	1) draw attention 2) pull sth on one side 3) extend/delay time
나누다	1) split, divide 2) distribute 3) experience sth with someone 4) greet/salute
나다	1) happen, occur 2) sth comes on the surface 3) get a flaw 4) get a feeling 5) hear sound/voice 6) grow/start (ex a rumor)
날리다	1) fly 2) lose sth (flew away) 3) become well known
내다	1) give money 2) submit sth 3) buy food 4) to get an emotion
내리다	1) disembark,dismount 2) fall from the sky 3) decrease,lower sth
내밀다	1) to stick out 2) to receive and give sth 3) hold
놀다	1) play 2) be idle 3) be out of work/school
놓다	1) drop sth from our hands 2) release sth or smb 3) sth is somewhere 4) rest easy
달리다	1) run 2) hang 3) be insufficient 4) "it's all in your mind" 
담다	1) put sth in sth, bottle/box up sth 2) reflect contents 3) include
당기다	1) pull sth closer 2) change date 3) give appetite
돌다	1) turn, move towards one direction 2) go round 3) change direction
돌리다	1) "share" sth equally with others 2) operate (ex laundry machine) 3) turn, spin, change direction
두다	1) put sth somewhere 2) leave, store sth somewhere 3) have
들다	1) lift/pick up sth 2) to give an example 3) have/eat food
들이다	1) devote 2) to be used to 3) instill
따다	1) pick, pluck 2) get certified 3) get money
따르다	1) do as said 2) follow 3) pour (a drink)
따지다	1) determine,figure out 2) calculate 3) nitpick
때우다	1) substitute 2) kill time 3) fill, solder
뛰다	1) jump 2) raise price 3) beat, pound
막히다	1) be blocked 2) be speechless 3) be stopped,clogged
맞다	1) be correct 2) suit one's taste 3) agree
맞추다	1) do sth evenly 2) adjust sth to fit me 3) face each other
먹다	1) eat 2) get an emotion 3) grow older
먹이다	1) feed 2) support 3) soak,oil
박히다	1) be stuck 2) remain on my mind 3) be well stuck, embedded 
받다	1) get,take 2) hear news 3) receive
버티다	1) withstand 2) support 3) stand firm
보내다	1) send/mail sth 2) sent someone somewhere 3) express emotion
보다	1) see 2) clinically examine 3) buy things
부르다	1) yell 2) sing 3) invite someone
불다	1) wind blows 2) talk about sth/sb 3) breathe 4) play an instrument
붙다	1) stick 2) catch fire 3) pass (exam etc) 4) meet, touch (each other)
붙이다	1) stick,glue 2) light (a cigarette) 3) have (interest)
비다	1) empty, vacant 2) empty handed 3) have free time, be available
뽑다	1) pull, extract 2) elect, vote for 3) get sth new 4) make sth and treat someone
삼키다	1) swallow 2) steal from others 3) endure by force
상하다	1) get offended 2) go bad, spoil 3) get hurt
새다	1) leak (water) 2) leak (a secret) 3) have no money
생기다	1) sth new is build/created 2) how someone looks 3) something happens/occurs
서다 	1) be standing 2) stand 3) stop
세우다	1) raise something 2) make sth stop 3) build 4) create a chance
식히다	1) cool sth 2) subdue,reduce 3) ruin the mood
쓰다	1) draw 2) write 3) concern,worry 4) use (money)
얻다	1) receive get 2) obtain, buy 3) rent
열다	1) push or pull, open 2) start a business 3) open up (feelings)
오르다	1) go [up], climb 2) place, be placed 3) raise, increase, rise
올리다	1) move to a high place 2) raise price 3) hold (ie wedding ceremony)
입다	1) wear 2) get harmed,sustain damage 3) be indebted
잡다	1) kill,hunt 2) catch 3) stop sth in order to get on 4) choose sth and take it 5) make up my mind
주다	1) present 2) give 3) give <emotion> to someone
죽다	1) die, perish 2) extinguish 3) lose power
지내다	1) live, spend time 2) associate as friend etc 3) hold a ceremony
짓다	1) make/build sth 2) compose 3) make a facial expression
차다	1) be full 2) kick 3) to be chilly,cold
차리다	1) prepare,set 2) open,start up 3) come to one's senses
치다	1) to hit,strike 2) to play a music instrument 3) to exercise [depends on music instrument and exercise]
타다	1) ride,get on 2) exercise [ie ski] 3) burn,suntan 4) get anxious
터지다	1) burst,pop 2) crack 3) explode
풀다	1) blow off steam,resolve 2) solve 3) unwrap, unpack
풀리다	1) untie, loose 2) lift,clear (as in solved) 3) to be/get solved
피다	1) bloom, blossom 2) conditions get better 3) smile
피우다	1) light, burn 2) smoke 3) make trouble/be troubled
흘리다	1) cry, sweat, bleed, drool 2) carelessly drop/lose sth 3) spread rumous,spill the beans (for others to hear)
*** 반의어 - Antonyms (/course/634971/ebs-topik-ii-intermediateadvanced-vocabulary/3/)
가까이	멀리
가늘다	굵다
가입하다	탈퇴하다
간단하다	자세하다
갇히다	탈출하다
(눈을) 감다	뜨다
강하다/세다/튼튼하다	약하다
같이	달리
거절하다	받아들이다
걱정하다	안심하다
검다	희다
게으르다	lazy, idle
겸손하다	거만하다
계속하다	그만하다 / 그만두다
고백하다	감추다
고용하다	해고하다
공통점	차이점
관심	무관심
구입	판매
굽히다	젖히다
귀하다	천하다
금지하다	prohibit, ban, forbid
기쁨	슬픔
기억나다	잊어버리다
깨끗하다	지저분하다
꽂다	뽑다
(돈을) 꾸다 / 빌리다	갚다
끄다	켜다
끊다	잇다/연결하다
끼다	빠지다
나서다	물러서다
나타나다 / 드러나다	사라지다
낙천적	비관적
날씬하다	뚱뚱하다
낭비하다	to waste, dissipate
(목소리를) 낮추다	높이다 / 올리다
낯설다	unfamiliar (adj)
내부	외부
녹다	얼다
느긋하다	급하다
늘다	줄다
늘리다	줄이다
다정하다	무뚝뚝하다
담다	덜다
담다 / 넣다	꺼내다
당황하다	태연하다
대량	소량
대출하다	반납하다
대형	소형
던지다	받다
데우다	식히다
동의하다	반대하다
드물다	흔하다
떠들썩하다 / 시끄럽다	조용하다
떼다	붙이다
똑똑하다	smart, clever, bright, intelligent
뚜렷하다	흐릿하다
뜨다	가라앉다
막다	뚫다
맑다	흐리다
(짐을) 맡기다	찾다
모자라다	남다
몰려들다	흩어지다
무려	고작 / 겨우
미루다	당기다
밉다	사랑스럽다
바쁘다	한가하다
뱉다	삼키다
보태다	덜다
부드럽다	거칠다
부정	긍정
부족하다	충분하다 / 풍부하다
(시험에) 붙다	떨어지다
비다	차다
빌리다	돌려주다
서투르다	능숙하다
선명하다	흐릿하다 / 희미하다
선배	후배
선진	후진
성공하다	실패하다
소극적	passive, half-hearted
소중히	함부로
손해	이익
수입하다	수출하다
(고개를) 숙이다	들다
숨기다 / 감추다	드러내다 / 표현하다
슬퍼하다	기뻐하다
시들다	싱싱하다
(속이) 시원하다	답답하다
쓰러지다	일어나다
아끼다 / 절약하다	낭비하다
앞당기다	늦추다 / 미루다
앞서다	뒤지다 / 뒤처지다
어색하다	자연스업다
얼다	녹다
(기한을) 연기하다	앞당기다
(입을) 열다	다물다
(문을) 열다	잠그다
올려놓다	내려놓다
옳다	그르다
외향적	extroverted, outgoing
원인	결과
위험하다	안전하다
유능하다	무능하다
유리하다	불리하다
유치하다	childish, immature
이롭다	해롭다
잃다	얻다
입다	벗다
입원하다	퇴원하다
장점	단점
재우다	깨우다
젖다	마르다
주의하다	방심하다
증가하다	감소하다
지다	이기다
지루하다	재미있다
지출	수입
지키다	어기다 / 위반하다
직접	간접
진하다 / 짙다	옅다
집중하다	한눈팔다
참석하다	빠지다 / 불참하다
처음	끝
철저히	대충
최고	최저
최소한	최대한
축소하다	확대하다
출구	입구
(술이) 취하다	깨다
칭찬	꾸중
(차를) 타다	내리다
튀근하다	출근하다
(물을) 틀다	잠그다
펴다	개다
편안하다	불편하다
평범하다	특별하다
포함하다	제외하다
풀다	묶다
(짐을) 풀다	싸다
피하다	맞서다
합법	불법
합치다	나누다
행운	불운
화려하다	수수하다
환하다	어둡다 / 깜깜하다
흐리다	진하다 / 분명하다
*** 관용표현 - Idiomatic expressions (/course/634971/ebs-topik-ii-intermediateadvanced-vocabulary/4/)
가슴이 저리다	Heartbreaking. (속이 상해 마음이 쓰리고 아프다)
가슴에 못(을) 박다	Be deeply hurt in the heart (마음 속 깊이 분한 생각이 맺히게 하다)
가슴이 내려앉다	be greatly surprised (깜짝 놀라다)
가슴이 미어지다 (터지다)	Heart breaking (마음이 슬픔이나 고통으로 가득 차 참기 힘들다)
가슴이 아프다	Heartache (슬프거나 안타깝다)
가슴이 찡하다	감동하다
가시 방석에 앉다	to be on pins and needles (긴장되다/마음이 힘들고 부편한 상황에 있다)
가시밭걸을 가다	Walk on a thorny road (아주 어렵고 힘들게 살다)
간(이) 떨어지다	be shaken/shocked/frightened (매우 놀라다)
간담(간 & 쓸개)이 서늘하다	be taken aback;be frightened out of one´s senses (매우 놀라서 섬뜩하다)
간을 녹이다	Used when flattered (감언이설 등으로 상대를 사로잡음)
골치 아프다	have a headache because solving sth is hard (일을 해결하기 어려워서 머리가 아프다)
골칫덩어리	a pain in the butt, troublesome (말썽꾸러기)
국수를 먹다	used when someone is getting married and we eat due to the event (다른 사람이 결혼해서 대접을 받다)
굴뚝 같다	be anxious (to do), strongly wish (to do) (무엇을 하고 싶은 마음이 간절하다)
귀(가) 따갑다/귀(가) 아프다	1) When sth is painful to the ear 2) When we hate to hear sth (1. 소리가 날카롭고 커서 듣기에 괴롭다 2. 너무 여러 번 들어서 듣기가 싫다)
귀에 익다	be accustomed/used to hearing sth (어떤 말이나 소리를 자주 들어 버릇이 되다)
귀가 가렵다 [간지럽다]	i feel people are talking about me so my ears are itchy (남이 제 말을 한다고 느끼다)
귀가 뚫리다	be able to hear sth [and understand] (말을 알아듣게 되다)
귀를 의심하다	cannot believe one´s ears (믿기 어려운 이야기를 들어 잘못 들은 것이 아닌가 생각하다)
귀에 거슬리다	be harsh to the ear (듣기에 언짢은 느낌이 들며 기분이 상하다)
귀에 들어가다	come to someone's knowledge,become known (누구에게 알려지다)
기가 막히다	be at a loss for words (1. 어떤 일이 너무 놀랍고 황당하다 2. 매우 대단하다)
기가 죽다	feel cheap, lose heart (기세가 꺾여 약해지다)
깨소금 맛	arrogant, feel good with others' misfortune (남의 불행을 보고 매우 통쾌하다는 뜻으로 이르는 말)
날개 돋치다	sell like crazy (상품이 시세를 만나 빠른 속도로 팔려 나가다)
날개를 펴다	spread/open wings (씩씩하게 뜻을 드러내다)
날을 잡다	fix/decide date (날짜를 정하다)
낯이 뜨겁다	be embarrassed (1. 매우 부끄럽다 2. 보기에 민망하다) 
눈(꼴)이 시다	Hate to see, it bothers me (하는 짓이 거슬려 보기에 아니꼽다)
눈(알)이 빠지도록 기다리다	Anxiously waiting (매우 애타게 오랫동안 기다리다)
눈(에) 띄다	stand out, catch one's eye (두드러지게 드러나다)
눈(을) 돌리다	change interest, avert [turn away] one´s eyes (관심을 돌리다)
눈(을) 맞추다	to make eye contact (서로 눈을 마주 보다)
눈(을) 밝히다	to focus (무엇을 찾으려고 신경을 집중하거나 힘을 넣다)
눈(을) 붙이다	go to sleep (잠을 자다)
눈(을) 속이다	deceive someone, pull the wool over a person´s eyes (잠시 수단을 써서 보는 사람이 속아 넘어가게 하다)
눈을 피하다	avoid eye contact (남이 보는 것을 피하다)
눈(이) 꺼지다	one´s eyes become hollow, exhausted (눈이 우목하게 들어가다)
눈(이) 높다	have a well cultivated taste (정도 이상의 좋은 것만 찾는 버릇이 있다)
눈(이) 많다	to see many people (보는 사람이 많다)
눈(이) 삐다	used when u cannot see the obvious (뻔한 것을 잘못 보고 있을 때 비난조로 이르는 말)
눈에 거슬리다	be unpleasant to the eye (보기에 마뜩하지 않아 불쾌한 느낌이 있다)
눈에 밟히다	haunt one´s memory (자꾸 생각나다)
눈에 불을 켜다	1) do an action like crazy 2) get so angry that eyes are sparkling (1. 어떤 일을 집중해서 열심히 하다 2. 화가 나서 눈을 크게 뜨다))
눈에 익다	be accustomed to see [hear] (본 적이 있는 느낌이 들다)
눈에서 벗어나다	escape, get free (감시나 구속에서 자유롭게 되다)
눈을 끌다	be attractive (호기심을 일으켜 보게 하다)
눈을 의심하다	doubt one's eyes (잘못 보지 않았나 하여 믿지 않고 이상하게 생각하다)
눈이 뚫어지게	to stare (꼼짝 않고 한 곳을 응시하는 모양을 이르는 말)
눈이 캄캄하다	(be) gloomy, hopeless (정신이 아찔하고 생각이 콱 막히다)
눈이 트이다	awake from illusion, come to determine sth (사물이나 현상을 판단할 줄 알게 되다)
닳고 닳다	become oversophisticated (세상일에 시달려 약아빠지다)
담을 쌓다	build up a wall (관계없게 지내거나 관심을 완전히 끊다)
뜸을 들이다	waver, set stand (말이나 행동을 바로 하지 않고 머뭇거리다)
마음에 들다	be to one´s liking (자신의 느낌이나 생각과 같아서 좋다)
마음을 놓다	ease heart (걱정하지 않다)
마음을 비우다	empty mind, forsake greed (욕심을 버리다)
맛을 들이다	acquire a taste, be hooked on (어떤 것에 재미를 느끼다)
머리(를) 하다	fix one's hair (머리를 손질하다)
머리가 굳다	dull memories (기억력이 무디다)
머리가 썩다	old mindset (사고방식이나 사상이 낡아서 쓰지 못하게 되다)
머리가 크다 (굵다)	become adult (성인이 되다)
머리(를) 굴리다	put one's brain to work (머리를 써서 생각하다)
머리(를) 굽히다 (숙이다)	lower head, show low profile, modesty (굴복하거나 저자세를 보이다)
머리(를) 긁다	when u don't know sth and try to find the answer, scratching the head (수줍거나 무안해서 어쩔 졸 모를 때 그 어색함을 무마시키려고 머리를 긁적이다)
머리(를) 깎다	take the tonsure (shave hair as a sign of religious devotion), shave one's head to be a Buddhist monk (중이 되다)
머리(를) 식히다	rest one's mind (흥분되거나 긴장딘 마음을 가라앉히다)
머리(를) 싸고/싸매다	working with all my strength for what's gonna come next (있는 힘과 다음을 다해 노력하다)
머리가 (잘) 돌아가다	quit witted (임기응변으로 생각이 잘 떠오르거나 미치다)
머리가 가볍다	refreshing to the mind (상쾌하여 마음이나 기분이 거뜬하다)
머리가 무겁다	have a dull [heavy] feeling in the head (기분이 좋지 않거나 골이 띵하다)
머리를 쥐어짜다	squize one's brain (매우 애를 써서 궁리하다)
머리를 짓누르다	mental stimulation (정신적으로 강한 자극이 오다)
머리에 새겨 넣다	keep sth in mind (어떤 대상이나 사실을 단단히 기억해 두다)
머리에 파도 안 마르다	far from being an adult (아직 어른이 되려면 멀었다. 또는 나이가 어리다)
물과 기름	do not match each other (서로 어울리지 못하여 겉도는 사이)
물불을 가리지 않다	1. go through fire and water 2. be willing to take any risk (1. 어려움이나 위험을 무릅쓰고 행동하다 2. 어떤 일을 해도 되는지 안 되는지 생각 안하고 행동하다)
미역국(을) 먹다	fail an exam (시험에서 떨어지다)
바가지 쓰다/씌우다	be overcharged, be ripped off (요금이나 물건 값을 실제 가격보다 비싸게 내거나 내게 하다)
바가지(를) 긁다	henpeck, nag at (주로 아내가 남편에게 잔소리를 심하게 하다)
바람을 넣다	encourage sb to do sth (다른 사람에게 어떤 행동을 하려는 마음이 생기게 하다)
바람을 맞다	be rejected, stood up (상대방이 연락 없이 약속 장소에 나오지 않다)
바람을 쐬다	go out to get some air (기분을 바꾸려고 밖에 나가다)
발 벗고 나서다	throw oneself into a matter with enthusiasm (어떤 일을 하기 위해 적극적으로 행동하다)
발을 붙이다	rely on sb (의지하다)
발을 빼다	sever connections [relations] with (관계를 끊다)
발이 넓다 [너르다]	have a wide acquaintance (알고 지내는 사람이 많다)
발이 맞다	match well (잘 어울리다)
벽을 허물다	tear down a wall, obliterate disabilities (장애를 없애다)
복장(이) 터지다	feeling stuffy at the heart (매우 마음에 답답함을 느끼다)
비행기를 태우다	overpraise others (다른 사람을 지나치게 칭찬하다)
색안경을 끼다	have prejudice (편견을 가지다)
속(을) 긁다	hurt a person's feelings (남의 속어 뒤짐히게 비위를 살살 건드리다)
속(을) 끓이다	to worry about sth, be frustrated (마음을 태우다)
속(을) 뜨다 [떠보다]	guess a person's mind or feelings (남의 마음을 알려고 넘겨짚다)
속(을) 빼놓다	suppress one's feelings (줏대나 감정을 억제하다)
속(을) 썩이다	be bothered by a bad outcome/situation (뜻대로 되지 아니하거나 좋지 못한 일로 매우 괴로워하다)
속(을) 차리다	behave responsibly (자기의 실속을 꾸리다)
속(을) 태우다/타다	worry oneself about sth (우 걱정이 되어 마음을 졸이다)
속(이) 뒤집히다	to feel disgust, nausea (비위가 상해 욕지기가 날 듯하다)
속(이) 보이다	be easy to see through (엉큼한 마음이 들여다보이다)
속(이) 시원하다	a refreshing feeling (좋은 일이 생기거나 나쁜 일이 없어져서 마음이 상쾌하다)
속(이) 타다	be nervous (걱정이 되어 마음이 달다)
속이 풀리다	1. to calm down after being angry 2. bloated stomach is settling down  (1. 화를 냈거나 토라졌던 감정이 누그러지다 2. 거북하던 배 속이 가라앉다)
속에 얹히다	be displeased because of indigestion (마음에 걸리는 일이 있어 언짢다)
속에 없는 말 [소리]	say different from what one feel's (속마음과 다르게 하는 말)
속을 달래다	to comfort (속이 좋지 않은 상태를 좀 편하게 만들다)
속이 끓다	boil of anger (화가 나거나 억울한 일을 당해 격한 마음이 치밀어 오르다)
손에 놀다 (놀아나다)	finger play, easy to handle (모든 일이 자신의 수중에서 맘대로 움직이다)
손에 떨어지다	job is done (일이 끝나다)
손을 끊다	wash one´s hands of (one´s business); to finish a task/job (어떤 일을 끝내다)
손을 대다	to start sth (어떤 일을 착수하다)
손을 씻다	wash one´s hands of (one´s business) and sever ties (관계를 끊고 나쁜 일을 그만하다)
손이 놀다	to be at leisure (일거리가 없어 쉬는 상태에 있다)
손이 작다	1. to have few resources 2. to have few means  (1. 물건이나 재물의 씀씀이가 깐깐하고 작다 2. 수단이 적다)
손이 크다	1. to have many resources 2. to have many means (1. 물건이나 재물의 씀씀이가 깐깐하고 크다 2. 수단이 많다)
애가 타다	be anxious, agonized (매우 걱정하고 안타까워하다)
애를 먹다	strain (고생을 많이 하다)
애를 쓰다	make efforts (마음과 힘을 다하여 힘쓰다)
어깨가 가볍다/ 무겁다	to not have responsibility/to have responsibility (무거운 책임에서 벗어나 홀가분하다)
얼굴을 내밀다	show one's face (참석하다)
얼굴이 두껍다	be impudent[shameless, audacious] (창피하거나 부끄러운 것을 모르다)
열(을) 받다	burn (with anger) ;fume;lose one´s temper (사람이 감정의 자극을 받거나 격분하다)
오금이 저리다	knees go numb (마음을 졸여 심하게 긴장을 하다)
이(가) 갈리다/갈다	get really angry (매우 화가 나거나 분을 참지 못해 독한 마음이 생김)
입 (안)이 쓰다	displeased or bad tempered (어떤 일이나 말이 못마땅하여 기분이 언짢다)
입 밖에 내다	utter (어떤 생각이나 사실을 말로 드러내다)
입 안에세 [끝에세] (뱅뱅) 돌다	i want to say sth but i can't (하고 싶은 말이 있어도 하지 아니하거나 또는 못하게 되다)
입(말문)이 떨어지다	sliped my mouth (입에서 말이 나오다)
입(을) 다물다	shut one's mouth (말을 하지 아니하거나 하던 말을 그치다)
입(을) 막다	cover one´s mouth (시끄러운 소리나 자기에게 불리한 말을 하지 못하게 하다)
입(을) 맞추다	match each other's words (서로의 말이 일치하도록 하다) - can also mean "to kiss"
입(을) 모으다	with one mouth (여러 사람이 같은 의견을 말하다)
입(을) 씻다(닦다)	take the profit for one's self, pretend ignorance (이익을 혼자 차지하거나 가로채고서는 시치미 떼다)
입(이) 가볍다[싸다]	be talkative, loose tongued (말이 많거나 아는 일을 함부로 옮기다)
입만 살다	be all talk and no deed; be bold in word only (말에 따르는 행동은 없으면서 말만 그럴듯하게 잘하다)
입만 아프다	to talk in vain (여러 번 말해도 받아들이지 아니하여 말한 보람이 없다)
입에 (게)거품을 물다	froth[foam] at the mouth (매우 흥분해 떠들어댐)
입에 달고 다니다	use sth often (말이나 이야기를 습관처럼 되풀이하거나 자주 사용하다)
입에 담다	speak of; mention (무엇에 대해 말하다)
입에 대다	taste; eat (음식을 먹거나 마시다)
입에 맞다	suit one's taste (음식이나 하는 일이 마음에 들다)
입에 붙다	sth became a habit (아주 익숙하여 버릇이 되다)
입에 침이 마르다	talk non stop (입에 침이 마를 정도로 여러 번 말하다)
입을 딱 벌리다	one's mouth drops in shock or amazement (너무 기가 막혀 어이가 없어하거나 매우 놀라워하다)
입이 무겁다	knows how to keep a secret (비밀을 잘 지키다)
입이 아프다	talk in vain (여러 번 말해도 받아들이지 아니하여 말한 보람이 없다)
입이 짧다	have a small appetite (싫어하거나 먹지 않는 음식이 많다)
잔을 올리다	raise the cup (술을 드리다)
죽을 쑤다	fail at sth (어떤 일을 망치거나 실패하다)
쥐 죽은 듯하다	very quiet (매우 조용하다)
쥐구멍에 들어가다	hide in a hole coz too embarrassed (매우 부끄러워 그 자리를 피하고 싶다)
쥐도 새도 모르게	in secret;on the quiet;behind the scenes (아무도 모르게)
진땀을 흘리다	sweat hard in agony (긴장하거나 매우 힘들어하다)
찬물을 끼얹다	throw a wet blanket; pour cold water at.. (1.잘되어 가는 일을 망치다 2.매우 종용해진 상태)
찬바람이 불다	situation/atmosphere is getting chilly (1.분위기가 싸늘하다 2.사정이 나빠지다)
찬밥 더운밥 가리다	be fussy about one´s food (좋고 나쁜 것을 가리다)
코 묻은 돈	used to make fun of the pocket change kids carry around (어린아니가 가진 적은 돈)
코가 꿰이다	be restricted or hindered by something or someone (약점이 잡히다)
코가 빠지다	to lose one's nerve or spirit (근심에 싸여 기가 죽고 맥이 빠지다)
코가 납작해지다	be shamed by someone; lose one's nerve (매우 무안을 당하거나 기가 죽어 위신이 뚝 떨어지다)
코가 높다	to act proud (잘난 체하고 뽐내는 기세가 있다)
코가 비뚤어지게 [비뚤어지도록]	be very drunk (술에 매우 취하다)
코앞에 닥치다	be close at hand; be imminent (어떤 일에 시간이 얼마 남지 않다)
파김치가 되다	be extremely tired (매우 지치다)
피땀을 흘리다	work really hard (열심히 일하고 노력하며 지내다)
한솥밥을 먹다	live under the same roof (한 가족처럼 함께 생활하며 지내다)
한술 더 뜨다	outdo, sth gets even more bad (행동이나 말, 상황 등이 더 심해지다)
허리가 부러지다	work hard (힘들게 일하다)
허리가 휘다	working as hard as breaking one's back (생활고나 노동으로 힘겨운 상태가 되다)
허리띠를 졸라매다	living a simple life (1.검소한 생활을 하다 2.어떤 일을 이루려고 굳게 마음을 먹다)
허리를 굽히다	have a humble attitude (1.겸소한 태도를 취하다 2.굴복하다)
*** -INCOMPLETE- 의성어, 의태어 - onomatopoeia, mimetic word (/course/634971/ebs-topik-ii-intermediateadvanced-vocabulary/5/)
반짝반짝	glitteringly, brilliantly, dazzlingly
빙글빙글	turn[go] round and round
펄럭펄럭	flapping, with a flutter
홀짝홀짝	spinning around
스르륵	sound of light and smooth sliding
모락모락	sound of a smoke rising
보들보들	being soft, cuddly
미끌매끌	smooth, polished
따끈따끈	warm, heated
보글보글	bubbling, boiling
슬슬	slowly, leisurely
깡총깡총	hop, skip, jump up and down
흔들흔들	swinglingly, waveringly
울퉁불퉁	uneven, rugged, scraggy, jagged
울긋불긋	many-colored, picturesque
끄덕끄덕	nodding
옹기종기	in a small, close group; in a cluster
주렁주렁	in clusters, (grow) in full bearing
졸졸	murmuring, purling, babbling
쨍그랑	clink, clank
꽝	bang, boom, thud
빵	bam
쿵쿵	stamp, thump
똑똑똑	knock knock
딩딩딩	sound of bells
똑딱똑딱	tick tock
째깍째깍	sound of a clock
딩동	ding-dong
칙칙폭폭	sound of a train
삐걱	sound of a floor creaking
부릉부릉	sound of a car engine
삐뽀 삐뽀	siren wailing
똑똑	drip drop
지글지글	sizzle
*** -INCOMPLETE- 속담 - Proverbs (/course/634971/ebs-topik-ii-intermediateadvanced-vocabulary/6/)
*** 고객 센터 - Customer Center (/course/634971/ebs-topik-ii-intermediateadvanced-vocabulary/7/)
고장 신고	failure/damage report
기타 문의	more Questions
상담원 연결	cunnect to customer support
수리 센터 안내	repair enter information
요금 안내	payment information
이용 안내	operation information
가입하다	become a member
개통하다	activate, activation
설치하다	install
정지하다	stop, halt, suspend
해지하다	terminate, cancel (a contract)
고객 센터에 문의하다	inquire at the customer center
불만을 말하다	state/make a complaint
사용 설명을 문의하다	ask sb to explain how to use sth
상담원과 상담하다	consult with a customer service representative
상담원과 직접 통화를 원하다	want to speak directly with an agent
신제품을 안내하다	new product information
연락 가능한 연락처	contact address or number, where it is possible to be reached
재발급을 원하다	want a reissued item
직접 방문하다	visit personally
*** 공항	- Airport (/course/634971/ebs-topik-ii-intermediateadvanced-vocabulary/8/)
공항 터미널	airport terminal
국내선	domestic flight
국제선	international flight
기내 음식	airplane food
도착 시간	arrival time
면세점	duty free
세관	customs
여권	passport
여행 목적	travel purpose
왕복	round trip
출발 시간	departure time
탑승구	boarding gate
탑승권	boarding pass
편도	one-way trip
항공권	airline ticket
연착되다	delayed
이륙하다	take off
착륙하다	landing
비행기 표를 예약하다	reserve a plane ticket
시차가 나다	time difference
안전벨트를 매다	buckle safety belt
좌석을 바꾸다	change seats
짐을 찾다	find baggage
창가 쪽에 앉다	sit by the window
*** 도서관 - Library (/course/634971/ebs-topik-ii-intermediateadvanced-vocabulary/9/)
컴퓨터실	computer room (PC실)
도서 검색	book search
도서관 사서	librarian
연체료	late fee
열람실	reading room
이용 시간	service hours
자료실	reference room
저자	author
정보실	information room
제목	title
주제	subject, topic, theme
책꽂이	bookshelf, bookcase
청구기호	book reference number on the book
출판사	publisher
학생증	student iD card
대출하다	to borrow, loan
연체되다	overdue
조사하다	survey, investigate
대출이 불가능하다	can't borrow
책을 검색하다	search for a book
책을 돌려주다/반납하다	return a book
책을 빌리다	borrow a book
책을 찾다	find a book
*** 미용실 - Hairdresser's (/course/634971/ebs-topik-ii-intermediateadvanced-vocabulary/10/)
곱슬머리	curly hair
단발머리	short, bobbed hair
대머리	bald head
머리 모양	hair style
미용사	hair dresser
생머리	straight hair
스포츠머리	really short haircut
커트 머리	haircut
헤어스타일	hairstyle
드라이하다	to dry hair
면도하다	to shave
세팅하다	set (one's hair)
염색하다	dye hair
파마하다	to perm
선명하다	clear, distinct, sharp, vivid
드라이기로 머리를 말리다	to dry hair with a hair dryer
자연스럽다	natural
머리가 상하다	spoiled hair
머리를 감다	wash one's hair
머리를 기르다	let one´s hair grow long
머리를 깎다	get a haircut
머리를 내리다	let the hair down
머리를 넘기다	push back one's hair
머리를 다듬다	trim one's hair
머리를 손질하다	trim/ repair one's hair
머리를 땋다	braid one's hair
머리를 묶다	tie/ bind one's hair
머리를 빗다	brush one's hair
머리를 자르다	cut one's hair
머리에 핀을 꽂다	put a hairpin in one's hair
앞머리를 내리다	bangs
왁스를 바르다	apply wax
무스를 바르다	apply mousse to hair
짧게 자르다	to cut short
*** 부동산 - Real estate (/course/634971/ebs-topik-ii-intermediateadvanced-vocabulary/11/)
가스 요금	gas bill
거실	living room
계약금	deposit
계약서	contract
고시원	goshiwon (rentable single room)
관리비	maintenance cost
근처	nearby, vicinity
단독주택	detached house
대문	main entrance
독방	room to oneself
마당	yard, garden (not 정..)
베란다	veranda, porch
부동산 소개소	a property dealer
부엌	kitchen
상가	shopping district
새집	new house
새집증후군	sick house syndrome, sick building syndrome
수도세	water fee
신축	new building
아파트	apartment
안방	main room, bed room
오피스텔	studio flat
욕실	bathroom, bath
원룸	one-room apartment
월세	monthly rent
위약금	penalty for breach of contract
이사철	the reason house moving
자취방	rented room
작은방	small room
잔금	balance
전기 요금	electric charges
전세	a lease, a charter
정원	yard, garden (not 마..)
주택가	residential area
중개수수	brokerage, commission
중개인	middleman
평수	floor space measure (1평 = 3.3 sqm)
포장 이사	moving and packing
하숙집	boarding house
한옥	traditional Korean-style house
합숙	dorm
현관	door, entrance
화장실	bathroom, toilet
이사하다	to move house
깨끗하다	to (be) clean
아늑하다	cozy
아담하다	neat, tidy, petite
계약 기간이 끝나다	the period of a contract is finished
공기가 좋다	good air
교통이 편리하다	the traffic commute is convenient
교통이 불편하다	to lack traffic facilities
교통편이 좋다	good transportation
교통편이 나쁘다	poor transportation
난방이 잘 되다	good heating
다 갖추어 져 있다	be fully furnished
방이 밝다	bright room (not 환...)
방이 어둡다	dim room
방이 비다	vacant room
방이 환하다	the room is bright (not 밝..)
보증금을 내다	pay security
새로 짓다	newly build
시설이 좋다	good facilities
위치가 좋다	be well-located
전망이 좋다	have a magnificent view
주변 경치가 좋다	good surrounding scenery
지은 지 오래되다	build long ago
지하철역에서 가깝다	subway station close by
지하철역에서 멀다	far from the subway station
집 주변이 조용하다	quiet surroundings
집 주변이 시끄럽다	noisy surroundings
집세를 내다	pay the rent
집세를 올리다	raise the rent
집을 보다	to look at a flat
집을 옮기다	move house
집을 장만하다	buy a house
집을 마련하다	become a house owner
집이 낡다	old-fashioned flat
천천히 둘러보다	leisurely look around
햇빛이 잘 들다	sunny, open for sunlight
화장실이 딸려 있다	a toilet belongs to the flat
*** 수리 센터 - Repair Center (/course/634971/ebs-topik-ii-intermediateadvanced-vocabulary/12/)
무상 수리	repair free of charge (not with 주다)
보증 기간	guarantee term (time)
부품	part, component
수리비	repair cost
고치다	repair, fix, mend (not 수..,not 수선..)
망가지다	be out of order, break down
수리하다	repair, mend, fix, overhaul (not 고..,not 수선..)
수선하다	mend, repair (not 고..,not 수리..)
점검하다	check, inspect, examine
고장 나다	break down, dysfunction
무료로 수리해 주다	repair free of charge
부품을 교체하다	replace a part
점검을 받다	undergo an inspection, have sth checked
*** 약국 병원 - Pharmacy, Hospital (/course/634971/ebs-topik-ii-intermediateadvanced-vocabulary/13/)
가루약	powdered medicine
간호사	nurse
감기약	cold medicine, influenza drug
결막염	eye inflammation, conjunctivitis
고열	high fever
구토	vomit, nausea, sickness
기관지염	bronchitis, bronchial trouble
난치병	hard curable disease
내과	department of internal medicine
두드러기	hives, nettle rash, urticaria
두통	headache, migraine
멀미약	antiseasickness pills, medicine for nausea
병명	name of a disease
병문안	to visit a sick person or patient
복통	stomachache, abdominal pain
부작용	side effect
불면증	insomnia, sleeplessness
비타민	vitamin
산부인과	gynecology, obstetrics
상비약	household medicine
성형외과	plastic surgery, cosmetic surgery
소독약	disinfectant, antiseptic
소아과	pediatrics, pediatric hospital
소화제	digestive medicine
수면제	sleeping pill, sleeping tablet
식중독	food poisoning
안과	department of ophthalmology
안약	eye drops
알레르기	allergy
알약	tablet, pill
약 처방전	medical prescription
약봉지	a medicine packet
여드름	pimple, acne
연고	ointment, salve
외과	department of surgery
위염	gastritis
의사	physician, doctor
이비인후과	ENT (ear, nose, throat) department
장염	enteritis
정신과	department of psychiatry
정형외과	orthopedics
주사	injection
증상	symptom (not ..세)
증세	symptom (not ..상)
진료실	doctor's office, consulting room
치과	dental clinic
치통	toothache
편두통	migraine
피부과	dermatology
한의원	oriental medical clinic
해열제	fever reducer
환자	patient
간호하다	nurse, attend, care for, look after
감염되다	get infected
과식하다	eat too much
다치다	get injured, be wounded
문지르다	rub, scour, scrub
부러지다	get broken, fracture, snap
부어오르다	swell up
붓다	become swollen, be sore
삐다	sprain, twist, wrench
설사하다	have loose bowels (diarrhea)
수술하다	perform an operation
입원하다	enter a hospital
접수하다	accept, receive
주무르다	massage, rub down, touch
진찰하다	examine, give a checkup
체하다	have an upset stomach
치료받다	receive a treatment
치료하다	give a treatment
콜록거리다	to cough, have a fit of coughing
토하다	vomit, throw up, puke
퇴원하다	leave a hospital
가렵다	itchy
더부룩하다	bloated
따갑다	have a stinging (prickling, hot) sensation
매슥거리다	feel like throwing up, feel sick to one´s stomach
지끈거리다	have a splitting headache
감기에 걸리다	catch a cold
과로로 쓰러지다	collapse because of extreme fatigue
기운 없다	have no energy or vitality, be weak
힘이 없다	be weak, be feeble
기침을 하다	to cough
깁스를 하다	wear a cast
내성이 생기다	develop a tolerance
눈병에 걸리다	get an eye disease
눈이 따갑다	a stinging in the eye
눈이 빨갛게 충혈 되다	eyes being inflamed and red
두퉁이 심하다	a severe headache
머리가 띵하다	be numb with a headache
목이 쉬다	have a hoarse throat
몸이 쑤시다	feel pains all over the body
발에 물집이 생기다	get a blister on one´s foot
배탈이 나다	have a stomachache, suffer from indigestion, have an upset stomach
병원에 실려 가다	be carried to the hospital
병이 나다	catch a disease, fall sick
병이 낫다	get well, recover, be cured
병이 회복되다	recover
부작용이 생기다	causing side effects
불면증에 걸리다	suffer from insomnia
붕대를 감다	wind a bandage
상처를 소독하다	disinfect a wound
소화가 안 되다	can not digest
속이 쓰리다	have a burning feeling in one's stomach
속이 울렁거리다	feel nausea
손을 베다	cut one´s hand
시력이 나빠지다	degeneration of one's vision
식전에 먹다	eat before meal
식후에 먹다	eat after meal
안색이 안 좋다	have no good color (becoming pale)
약을 바르다	apply medicine
약을 복용하다	take medicine
약이 잘 들다	the medicine has a positive effect
얼굴에 뭐가 나다	have something in the face (pimple)
엑스레이를 촬영하다	take x-ray pictures
열이 나다	have a fever
임신을 하다	be/ get pregnant
입 안이 헐다	have canker sores in one's mouth
재채기가 나다	to sneeze
종합검진을 받다	receive a comprehensive medical testing, get a check-up
주사를 맞다	get an injection
진료를 받다	get treatment
찜질을 하다	get a poultice
처방전을 받다	receive a prescription
충치가 생기다	have a tooth decay/ cavity
코피가 나다	have a bleeding nose
콧물이 나오다	have a running nose
퉁퉁 붓다	become swollen (eyes, face etc.)
파스를 붙이다	stick a medicated patch
밴드를 붙이다	put on a Band-Aid
반창고를 붙이다	apply a sticking plaster
피가 나다	to bleed
*** 우체국 - Post office (/course/634971/ebs-topik-ii-intermediateadvanced-vocabulary/14/)
국제 특급	express mail service (EMS)
날짜	date
물건	thing, stuff
받는 사람	recipient
배편	by ship
항공편	by plane
보내는 사람	sender
보통 우편	ordinary mail
저울	scale, scales, balances
퀵 서비스	quick service
택배	parcel service
특급 우편	special mail
포장	packaging, wrap, pack, package
깨지다	break, smash, shatter, crack
도착하다	arrival, arrive, reach, get, come in, get in
부치다	send, dispatch, mail, post, ship, wire, remit
파손되다	be damaged, be destroyed
소포를 보내다	send a package
엽서를 사다	buy a postcard
우편번호를 쓰다	write zip code
우표를 사다	buy stamps
주소를 적다	write the address
편지를 보내다	send a letter
*** 분실문 보관소 - Lost and Found (/course/634971/ebs-topik-ii-intermediateadvanced-vocabulary/15/)
분실 신고	report the loss of sth
분실물	lost article, missing article, lost property
선반	shelf, rack
기억나다	remember
놓다	lay, put, place
두다	put, place, leave, keep
떨어뜨리다	drop, lose
분실하다	lose, miss
빠뜨리다	omit, leave out, miss, drop, throw away
빠지다	fall out, deflate, drain
습득하다	find, pick up, aquire
잃어버리다	lose
줍다	pick up, find, gather, glean
흘리다	cry, shed, sweat, perspire, bleed, drool, slobber, spill, drop
놓고 나오다	to leave sth. in a place
두고 내리다	to leave sth. back in a place
신고서를 쓰다	write a declaration
신분을 확인하다	to identify
신분확인	identification
연락 가능한 연락처	contact address or number where it is possible to be reached
지갑을 줍다	pick up a wallet
*** 은행 - Bank (/course/634971/ebs-topik-ii-intermediateadvanced-vocabulary/16/)
계좌번호	account number
금액	sum, amount
달러	dollar
서류	document, papers
수표	check, cheque
신용카드	credit card
외국인 등록증	certificate of alien registration
원화	Korean Won
직불카드	debit card
체크카드	check card
카드 발급 신청서	card issue application form
발급	issuance
신청서	application form
통장 발급 신청서	bankbook issue application form
통장	bankbook
현금 서비스 카드	cash service card
현금	cash, ready money
현금자동인출기	ATM
환율	exchange rate
서명하다	put one's signature
송금하다	send money, transfer
입금하다	make a deposit
재발급하다	re-issue
저축하다	save, deposit, put sth away
해지하다	cancel (a contract), close, terminate
환전하다	exchange, change
계좌이체를 하다	transfer money between accounts
공과금을 납부하다	pay utility bills
대출을 받다	borrow money, get a loan
도장을 찍다	fix a seal
돈을 보내다	send money
돈을 찾다	withdraw money
비밀 번호를 누르다	press (enter) the secret number
비밀 번호를 잊어버리다	forget the secret number
송금을 받다	receive remittance
신분증을 내다	turn in identification
신청서를 쓰다	write application
연체료를 내다	pay late fee charge
인터넷 뱅킹을 신청하다	subscribe for internet banking
잔액을 조회하다	make balance inquiries
카드를 만들다	get a credit card
통장을 만들다	open a savings account
*** 호텔 - Hotel (/course/634971/ebs-topik-ii-intermediateadvanced-vocabulary/17/)
객실	room, cabin
빈방	vacancy, vacant room
숙박비	room charge
숙소	lodging, accommodations
여행 목적	travel purpose
숙박하다	lodge, stay, put up
귀중품을 맡기다	place valuables in a person´s custody
귀중품을 보관하다	entrust valuables to
룸서비스를 부탁하다	request the room service
방 열쇠를 맡기다	entrust the room key
맡기다	leave, put, check, deposit
방을 바뀌다	change the room
방을 예약하다	book a room
열쇠를 잃어버리다	lose the key
열쇠를 주다	hand over the key
짐을 들어주다	help sb. to carry the luggage
짐	baggage, luggage, load, burden, freight, cargo
짐을 로비로 내리다	drop the luggage at the lobby
로비	lobby
짐을 맡기다	check/entrust one's luggage
호텔에 묵다	stay at a hotel
묵다	stay (at a hotel)
*** 가정 - House,housekeeping (/course/634971/ebs-topik-ii-intermediateadvanced-vocabulary/18/)
대청소	big clean-up
분리수거	recycling bin
엉망	mess, wreck, disorder
집안일	house work
걸레질하다	to wipe with a cloth, scrub
다림질하다	to iron
닦다	to clean, wipe
빨래하다	to do laundry
살림하다	housekeeping
설거지하다	to do dishwashing
정돈하다	to tidy up, to clean up (ㅈ)
정리하다	to organize
치우다	to tidy, to clean (ㅊ)
환기시키다	to air out the room
지저분하다	to be dirty (adj)
구석 구석 청소하다	to clean carefully
단추를 달다	to sew on a button
먼지를 털다	to dust off
못을 박다	to nail sth
바닥을 빗자루로 쓸다	to sweep the floor with a broom
반찬거리를 사다	to buy side dishes
변기를 뚫다	to unclog a toilet
빨래를 개다	to fold the laundry
빨래를 널다	to hang the laundry
서랍을 정리하다	to organize the drawers
쓰레기를 내다 놓다	to take out the garbage
쓰레기를 분리하다	to separate trash
어린이집에 아기를 맡기다	to send the kid to daycare
옷을 꿰매다	to sew clothes
옷을 세탁기에 넣고 돌리다	to put the clothes in the washing machine and wash them
옷이 구겨지다	the clothes have wrinkles, creases
음식을 장만하다	to prepare food
이불을 털다	to dust off the blanket
이불을 널다	to hang a blanket
장을 보다	to do grocery shopping
전구를 갈다	to change a light bulb
청소기를 밀다	to clean with the vacuum cleaner ( 밀다)
청소기를 돌리다	to clean with the vacuum cleaner  ( 돌리다)
현관문을 잠그다	to lock the front door
*** 감정 - feelings,emotions (/course/634971/ebs-topik-ii-intermediateadvanced-vocabulary/19/)
감동적	moving, touching
다행	relief
감동하다	to be moved
감사하다	to appreciate, thank, be thankful
감탄하다	to admire, to wonder
걱정하다	to worry
격려하다	to encourage, cheer up
고민하다	to worry, agonize, be concerned
그리워하다	to miss, long for, yearn for
기대하다	to expect , anticipate
기뻐하다	to be glad, be pleased, be delighted
긴장하다	to  be nervous, tense
놀라다	to be surprised, be astonished
떨리다	to be nervous
멀어지다	to grow apart
반성하다	to  reflect
사과하다	to apologize
설레다	to be joyful
슬퍼하다	to be sorrowful
실망하다	to be disappointed
싸우다	to argue, quarrel
다투다	to quarrel, fight
오해하다	to misunderstand
욕하다	to swear at, curse
웃다	to laugh
의심하다	to doubt
이해하다	to understand
조심하다	to be careful
존경하다	to respect, admire
주의하다	to be cautious, aware
즐거워하다	be delighted
참다	to suppress, to restrain
초조하다	to be restless, nervous, anxious, impatient
투덜거리다	to complain
화풀이하다	to vent one's anger
화해하다	to reconcile
흥분되다	to be excited
힘들어하다	to be hard on someone
가엾다	poor, pitiful, pathetic (adj)
갑갑하다	stuffy, suffocating, stifling (갑) (adj)
고맙다	thankful, grateful (adj)
괴롭다	painful, distressed (adj)
그립다	miss, long for (adj)
기쁘다	glad , happy , pleased (adj)
답답하다	stuffy, stifling, suffocating (답) (adj)
당황하다	be embarrassed, be flustered (adj)
무섭다	scary, frightening, terrifying (adj)
미안하다	to be sorry (adj)
밉다	to hate (adj)
부끄럽다	shameful, embarrassed (adj)
불쌍하다	pitiful, pathetic (adj)
불안하다	to be anxious, uneasy (adj)
뿌듯하다	to be satisfied, proud (adj)
삐치다	to sulk (adj)
사랑스럽다	to be lovable, adorable (adj)
서운하다	to be hurt, sad (adj)
섭섭하다	to be sorry, disappointed (adj)
소용없다	to be useless (adj)
속상하다	to be upset, distressed, annoyed (adj)
슬프다	to be sad, mournful (adj)
실망스럽다	to be disappointing (adj)
아깝다	to pity (adj)
아쉽다	sorry, sad (아) (adj)
안쓰럽다	to be pathetic, pitiable (adj)
안타깝다	to be regrettable, sad, pitiful (adj)
얄밉다	to be hatefu (adj)
영광스럽다	to be glorious, honorable, honored (adj)
외롭다	to be lonely, solitary, lonesome (adj)
우울하다	to be depressed,  gloomy  (adj)
의기소침하다	to be dispirited (adj)
자랑스럽다	to be proud of (adj)
죄송하다	to be sorry (죄) (adj)
즐겁다	to be pleasant, pleased (adj)
창피하다	to be embarrassed, ashamed  (창) (adj)
행복하다	to be happy (adj)
황당하다	to be absurd, ridiculous, nonsensical (adj)
후회스럽다	to be regretful (adj)
후회하다	to regret (adj)
기분이 좋다	to feel good
눈물이 나다	to cry
말로 표현할 수 없다	can't express by words
미소를 짓다	to smile
보람을 느끼다	to feel sth is worth
부담을 느끼다	to feel burden
불만이 많다	to be discontent
성취감을 느끼다	to feel sense of accomplisment
소리를 지르다	to shout out
스트레스를 받다	to have stress
스트레스를 풀다	to relieve stress
신경을 쓰다	to care, pay attention to
의욕이 생기다	to desire
자기 기분만 생각하다	to think only about one's ownself
자부심을 느끼다	to feel self-conceit, feel betrayed
자신감이 있다	to be confident
자신이 있다	to have confidence
자신이 없다	to lack confidence
정신을 차리다	to recover one's senses
짜증을 내다	to be fret
짜증이 나다	to act irritated
펑펑 울다	to cry a lot
표정을 짓다	to have a happy look
풀이 죽다	to have the blues, be in low spirit
한숨을 쉬다	to sigh
화가 나다	to be/get upset
화를 내다	to become angry at
후회가 들다	to feel regret
*** 건강 - Health (/course/634971/ebs-topik-ii-intermediateadvanced-vocabulary/20/)
고혈압	high blood pressure, hypertension
금연	no smoking
뇌종양	brain tumor
단백질	protein
당뇨병	diabetes
만성 피로	chronic fatigue
백혈병	leukemia
변비	constipation
비만	obesity
빈혈	anemia
성분	ingredient, component, constituent
성인병	adult disease
소화불량	indigestion
속 쓰림	heartburn
수면부족	lack of sleep
식중독	food poisoning
알레르기	allergy
알콜중독	alcoholism
암	cancer
열풍	fever
영양분	nourishment, nutrient
우울증	depression
위산 과다	excessive acid in the stomach
위산 부족	lack of stomach acid
유전병	a hereditary disease
자폐증	autism
전염병	infectious/contagious disease
지방	fat
채식	vegetarian diet
치매	dementia
치질	hemorrhoids
콜레스테롤	cholesterol
탄수화물	carbohydrate
피부병	skin disease
호르몬	hormone
흡연	smoking
과로하다	overwork
과식하다	overeating
과음하다	excessive drinking
섭취하다	ingest, take in
소화시키다	to digest
예방하다	to prevent
전염시키다	to transmit
편식하다	to eat only what one wants
폭식하다	to binge
함유하다	to contain
부족하다	insufficient (adj)
충분하다	sufficient, enough (adj)
가슴이 답답하다	feel a pressure on one's chest, feel heavy
건강에 신경 쓸 겨를이 없다	no time to take care of one's health
건강에 해롭다	be bad for one's health
건강에 이롭다	beneficial to health
건강을 타고 태어나다	be born healthy
건강을 해치다	harm one's health
규칙적인 식사를 하다	eat regularly
근력을 강화시키다	strengthen muscular strength
근육을 풀어주다	relax the muscles.
노화를 방지하다	prevent aging
뇌가 발달하다	develop brain
머리가 띵하다	have a dull headache
면역을 강화시키다	strengthen immunity
무리한 다이어트	excessive dieting
병을 앓다	suffer from a disease
빈혈을 일으키다	suffer from anemia
사고력이 떨어지다	thinking ability is dropping
세균을 옮기다	carry virus/germ
수면에 영향을 미치다	have influence on sleeping
습관을 생활화하다	make something way of life
신체가 발달하다	body development
심폐 기능을 강화하다	strengthen cardiopulmonary function
약물에 중독되다	become drug addicted
얼굴이 화끈거리다	one's face is hot
에너지를 만들다	produce energy
영양이 결핍되다	insufficient nutrient
영양이 풍부하다	sufficient nutrient
위를 보호하다	protect the stomach
유연성을 기르다	improve flexibility
증상을 완화시키다	relieve symptoms
질병을 막다	prevent disease
집중력을 향상시키다	improve concentration
집중력이 저하되다	diminished ability to concentrate
채소 위주의 식습관	vegetable diet
체력을 강화하다	strengthen physical strength
체력을 유지하다	preserve physical strength
체온을 떨어뜨리다	lower one's body temperature
체온이 올라가다	rise body temperature
폐활량을 증가시키다	increase lung capacity
피로를 풀어주다	relieve fatigue
혈압을 떨어뜨리다	lower blood pressure
혈액 순환 장애	circulatory disturbance
혈액 순환을 돕다	help blood circulation
혈액 순환이 잘되다	good blood circulation
혈액 순환을 개선하다	improve blood circulation
혈액의 흐름이 원활하다	smooth blood flow
*** 경제 - Economy (/course/634971/ebs-topik-ii-intermediateadvanced-vocabulary/21/)
경기 부양책	reflation measures
경제 위기	financial crisis
경제 지표	an economic indicator
경제관	economic view
고부가가치	high added value
고용 위기	employment crisis
금융계	the financial world
상반기	the first half year
소득	income, earnings, profits
소비	consumption
유동 자금	funds
잔고	balance
재테크	investment techniques
주식 시장	a stock market
투자	investment
하반기	the second half
급등하다	to skyrocket
급락하다	to collapse, crash
성장하다	to grow
쇠퇴하다	to decline
침체하다	to stagnate
경기가 안 좋다	the economy/business is bad
경제가 발전하다	the economy is developing
경제가 위축되다	the economy is shrinking
경제가 활기를 띠다	the economy began to show signs of activity
경제가 회복되다	the economy is recovered
경제관념이 없다	there is no economic sense
경제를 살리다	to save the economy
경제적 가치 만들다	make economic value
경제적 부를 누리다	enjoy economic wealth
경제적 이익이 발생하다	generate economic profit
근검절약하는 소비 생활	a thrift and saving consumption life
금리가 하락하다	lower the interest rate
당분간 지속하다	continue for a while
무리하게 투자하다	excessive investment
무역 협정을 맺다	contract a trade agreement
물가 상승의 주원인	the main cause of inflation
물가가 상승하다	the price is inflating
물가가 하락하다	prices turn downward
물가가 안정세를 보이다	prices seem to be stabilizing
물가가 오르다	prices are going up
물가가 큰 폭으로 뛰다	prices are going into the large margins
변동이 없다	show no change
부도가 나다	go bankrupt
생활비 지출 내역	living expense details
서민 경제가 되살아나다	domestic economy revival
선진국 대열에 합류하다	join the ranks of developed countries
소비가 활성화되다	consumption is invigorated
손실의 우려가 있다	there are fears of loss
수입과 지출을 관리하다	manage income and expenses
수출 부진을 겪다	go through the slump of export
수출 의존도가 높다	have a high dependence on exports
시장을 개방하다	open market
신용카드 대금을 내다	to pay the credit card
앞으로의 경제 전망	the future economic prospects
연말까지 이어지다	continue until the end of the year
위기를 맞다	encounter a crisis
위기를 극복하다	overcome a crisis
유가가 급등하다	oil price rising
유가가 급락하다	oil price collapsed
제자리걸음을 하다	remain stationary
주가가 폭등하다	the stock prices spiked
주가가 폭락하다	the stock prices collapsed
주식 시장에 변동이 생기다	there's change in the stock market
지역 경제 부흥을 꿈꾸다	dream of becoming a regional economic development
투자를 늘리다	increase investment
하락세로 돌아서다	prices are on a downturn
하반기에도 계속되다	continue in the second half
현상을 유지하다	maintain the status quo
호황기를 맞다	welcome a period of prosperity
불황기를 맞다	face economic hard times
화폐가치가 상승하다	the value of money is increasing
화폐가치가 떨어지다	the value of money is dropping
환율이 상승하다	rise of exchange rate
*** 계획, 희망 - Plan, hope (/course/634971/ebs-topik-ii-intermediateadvanced-vocabulary/22/)
가치관	one's values
목표	goal
믿음	belief
새해 계획	new-year resolution
예정	schedule, expectation
인생관	one's view of life
작심삼일	short-lived resolution, can't stick with anything
결심하다	to determine
결정하다	to make a decision
노력하다	to make an effort
마음먹다	to make up one's mind
성공하다	to succeed
실패하다	to fail
실천하다	to put sth into practice, to fulfill
포기하다	to give up
간절하다	to be keen on (adj)
개인의 행복을 추구하다	to pursuit one's own happiness
계획을 세우다	to plan sth
계획이 있다	to have plan
규칙적으로 지키다	to stick to a plan
기대가 크다	(to have) big expectations
꿈을 이루다	to achieve someone's dreams
노력을 기울이다	make every possible effort
능력을 발휘하다	to show one´s ability
목표를 달성하다	to achieve one's goal
반드시 목표를 이루다	to accomplish goal at all costs
복권에 당첨되다	to win the lottery
세부 계획을 세우다	to make a detailed plan
실행으로 옮기다	put sth into action
인생의 목표	goal of life
장기적인 안목을 가지다	to take a long-term view
전략을 수립하다	to establish strategy
최선을 다하다	to do one's best
행복한 가정을 꾸리다	to make a happy family
*** 공연, 전시회 - Shows, exhibitions (/course/634971/ebs-topik-ii-intermediateadvanced-vocabulary/23/)
감독	director, supervision
감동적	moving, touching
개봉	release, premiere
객석	seat, auditorium
공연장	theater
공포 영화	horror movie
관객	audience
극장	movie theater
매표소	box office
멜로 영화	melodrama
뮤지컬	musical
박람회	fair, expo
반전	twist,reversal
배우	actor, actress
분위기	mood
시사회	preview
시청자	viewer
애니메이션	animation
액션 영화	action movie
야외무대	outdoor stage
연기	performance, acting
연예인	celebrity
연주회	concert, recital
영화관	cinema
영화제	film festival
오페라	opera
음향 시설	sound equipment
인상적	memorable, impressive
일반석	general admission seat
입장권	ticket
전시회	exhibition, show
조연	supporting actor
좌석	seat
주인공	main character
초대석	reserved seat
출연자	the cast
코미디 영화	comedy movie
콘서트장	concert place
특별 공연	special performance
해피엔딩	happy ending
각광받다	get the spotlight
감상하다	to appreciate
관람하다	to watch
구경하다	to look around
반영하다	to reflect, to mirror
상영하다	to show, play, screen
연출하다	to direct
환호하다	to cheer
애절하다	pathetic (adj)
재미없다	not fun, uninteresting (adj)
지루하다	to be boring, bored, dull (adj)
흥미진진하다	to be exciting, interesting (adj)
가슴/심금/마음을 올리다	used when someone is touched/moved by sth
감동을 받다	be impressed
관객을 동원하다	call out/mobilize spectators
구성이 치밀하다	plot is detailed, elaborate
구성이 탄탄하다	tightly-plotted, solid plot
긴장감이 넘치다	suspenseful, tense
내용이 딱딱하다	hard content
눈물샘을 자극하다	tearful
눈을 뗃 수 없다	be unable to take one's eyes off
대중의 취향에 맞다	suit the public's taste
박수를 치다	applaud
박수를 받다	receive applaud
배역을 완벽하게 소화하다	play the role perfectly, act perfect
보는 재미를 더해 주다	make more enjoyable to see
선착순으로 포를 배포하다	first come first served ticketing
세계 시장에서 환영을 받다	get welcomed in the world market
세계적으로 인정받다	receive world recognization
소름이 돋다	get goose bumps
실감 나다	be realistic
실화를 바탕으로 하다	based on a true story
아쉬움이 남다	something was "missing"
압권이다	the best part, climax, highlight
연기력이 뛰어나다	outstanding performance
외면을 당하다	to be/get disregarded
인기를 끌다	(attract) gain popularity
인기를 많이 얻다	gain popularity
작품성이 뛰어나다	outstanding cinematic quality
장면을 잊을 수 없다	can't forget the scene
줄을 서다	to line up
코서트를 열다	open concert
표를 예매하다	reserve ticket
함성을 지르다	shout
호소력이 짙다	appealing, captivating
호평을 받다	be well received
혹평을 받다	be subjected to severe criticism
*** 과학과 발전 - Scientific development (/course/634971/ebs-topik-ii-intermediateadvanced-vocabulary/24/)
고체	solid
과학 현상	scientific phenomenon
기계 문명	machine civilization
기체	gas
끓는점	the boiling point
돌연변이	mutation
디지털 문명	digital civilization
로봇	robot
마찰력	frictional force
발전소	power plant
산성	acidity
산소	oxygen
수소	hydrogen
승화	sublimation
시기상조	prematurity
알칼리성	alkalinity
압력	pressure
액체	liquid
액화	liquefaction
어는점	freezing point
에너지	energy
영감	brainstorm, inspiration
우성	dominant
열성	enthusiasm
우주선	spaceship
우주여행 상품	space-traveling product
우주여행	a space trip
원리	principle, fundamentals
원심력	centrifugal force
유일무이	be unique
유전병	a hereditary disease
유전자	gene
으뜸	the best, the top, the head
응고	coagulation, clotting
이산화탄소	carbon dioxide
전무후무	the unprecedented
중력	gravity, gravitation
중성	neutral
질량	mass
항공 우주국	space agency
해양 생물	marine organism
회의적	skeptical
획기적	groundbreaking, epoch-making
개발하다	develop, exploit
기발하다	novel, brilliant, original
기여하다	contribute to
내다보다	predict, foresee
발견하다	discover
발명하다	invent
예견하다	predict, foresee, forecast
유전되다	be inherited, be hereditary
이바지하다	contribute (to/toward)
탄생하다	be born
탐구하다	do research, study
탐사하다	explore (for)
현실화되다	actualization, realization, materialization
귀추가 주목되다	pay attention to issue
기대를 모으고 있다	be expected
난항을 겪다	experience stormy passage
단정하기에 이르다	reach to the conclusion
밀도가 낮다	underpopulated
밀도가 높다	overpopulated
부피가 크다	be bulky
부피가 작다	be small in volume
삶의 질을 향상하다	improve the quality of life
새로운 지평을 열다	open a new prospect
실마리를 제공하다	provide clues
우려를 낳고 있다	raise concern
우주선을 발사하다	launch a spaceship
유례를 찾아볼 수 없다	to be unprecedented
전기를 마련하다	it marked a milestone
*** 교육 - Education (/course/634971/ebs-topik-ii-intermediateadvanced-vocabulary/25/)
과열 경쟁	fierce competition
영재 교육	special education for the gifted
조기 유학	studying abroad at young age
주입식 교육	cramming education
체벌	physical punishment
왕따	outcast
학력 저하	academic performance declining
학벌주의	academic elitism
공교육의 질을 높이다	increase the quality of public education
교권이 추락하다	teacher's authority is declining
교육 환경이 열악하다	low education conditions
교육열이 높다	education fever is high
교육이 획일화되다	education becomes standardized
국제적 감각을 키우다	to cultivate the global sensation
눈높이를 맞추다	to match the level
능동적 참여를 유도하다	to induce active participation
다양성을 존중하다	to value/respect diversity
동기를 유발하다	motivate someone to do sth
따돌림을 당하다	to be ostracized (왕따를 당하다)
불평등학 교육의 기회	unequal education opportunity
사교육비를 줄이다	reduce private education expenses
수준을 고려하다	considering the level
우려를 낳다	cause worry
인재를 배양하다	foster a person to be competent
인재를 확보하다	to secure the talented and competent
일탈 행동을 하다	to have a deviant behavior
입시 위주의 교육 현실	education system that focuses only on college entrance
자기 주도적 성향이 떨어지다	self initiated tendency is dropping
적성과 소질을 살리다	to nurture one's talent and aptitude
지나친 사교육 문제	the problem of excessive private education
창의력을 기르다	to nurture creative ability
천편일률적이다	monotonous, dull, boring
*** 교통 - Traffic (/course/634971/ebs-topik-ii-intermediateadvanced-vocabulary/26/)
U턴 금지	U-turn prohibition
고속버스 터미널	express bus terminal
고속 버스	bus terminal
공항	airport
교통카드	transport card
기차역	train station
내리는 문	getting-off door
노선도	route map
다음 정류장	next stop (for buses)
버스 정류장	bus stop
시내버스	intra-city bus
시외버스 터미널	intercity bus station
시외 버스	intercity bus
신호등	traffic lights
여객선 터미널	passenger terminal
역무원	station employee
왕복	round-trip
운전면허증	driver’s license
일방통행	one-way street
종착역	last stop
지하철역	subway station
직행	direct trip
초보운전	novice driver
출발역	departure station
출퇴근 시간	commuting time
타는 문	door to ride
편도	one-way trip
표시판	indicator board
환승역	transfer station
갈아타다	to change, transfer
도착하다	to arrive
이륙하다	to get off the ground, to take off
직진하다	to go straight
착륙하다	to come down, to land
출발하다	to depart
탑승하다	to board (plane)
복잡하다	to be crowded (adj)
붐비다	
혼잡하다	to be overcrowded, chaotic, congested, busy, jammed
고속도로 가다	go to highway
국도 가다	go to national highway
버스전용차선으로 가다	go on an exclusive bus lane
교통이 편리하다	convenient transportation
교통이 불편하다	inconvenient transportation
교통카드를 충전하다	recharge a transportation card
길이 막히다	the road is blocked
단말기에 카드를 내다	pay at terminal pay at the bus card reader
반대 방향으로 가는 차를 타다	to go from the opposite direction
서서 가다	to stand
손잡이를 잡다	hold on to a strap
역을 지나치다	pass through station
차가 막히다	traffic jam
타고 가다	go on a ride
택시를 잡다	get a taxi
버스를 놓치다	miss the bus
한 걸음 물러서다	take a step backward
한 번에 가다	in one go
*** 교환,환불 - Exchange, refund (/course/634971/ebs-topik-ii-intermediateadvanced-vocabulary/27/)
불량품	defective product
신제품	new product (not ...상...)
고장 나다	to break
교환하다	to exchange
망가지다	to be out of order
바꾸다	to change, exchange
반품하다	to return, bring back
변심하다	to change one's mind
파손되다	to be damaged, be destroyed
환불하다	to refund
교환. 환불이 가능하다	to be exchangeable and refundable
디자인/색상에 불만이 있다	not satisfied with design/color
라벨을 훼손하다	the label is damaged
바느질이 잘못되다	needlework is wrong
변심으로 인한 환불	refund due to mind change
수리 서비스를 받다	receive repair service
얼룩이 있다	there's a spot (on the clothes)
영수증을 분실하다	lose the receipt
옷이 꽉 끼다	the clothes are tight / tight fit
옷이 꽉 헐렁하다	the clothes are loose / loose fit
유통기한이 지나다	pass the expiration date
음식이 상하다	food went bad
이물질이 들어 있다	there is foreign substance inside
작동이 안 되다	to be not working
전원이 켜지지 않다	the power is not turning on
제품을 개봉하다	to release a product
제품을 사용하다	to use a product
포장을 뜯다	to open package
품질이 떨어지다	quality reducing
휴대 전화의 통화 소리가 깨끗하지 않다	phone call reception is not clear
*** 날씨 - weather (/course/634971/ebs-topik-ii-intermediateadvanced-vocabulary/28/)
계절	season
고온다습	high temperature and humidity
기상청	the National Weather Service
꽃샘추위	spring cold, the last cold snap
냉방병	get sick from overexposure to air conditioning
단풍놀이	an excursion for viewing  autumn leaves
벚꽃놀이	a picnic under the cherry blossoms
비바람	storm, rainstorm
사계절	four seasons
삼한사온	a cycle of three cold days and four warm days  (三寒四溫)
열대야	tropical night
영상	above zero (degrees)
영하	below zero (degrees)
영향	influence, effect, impact
일교차	daily temperature range
자외선	ultraviolet rays, UV rays
저기압	low pressure
고기압	high pressure
전국	the whole country
중부 지방	central part (district)
남부 지방	southern part (district)
진눈깨비	sleet
집중호우	a localized torrential downpour
찜통더위	sweltering heat
천고마비	season of high sky and plump horses (天高馬肥)
체감온도	wind chill temperature
최저 기온	lowest temperature
최고 기온	highest temperature
폭설	heavy snow
폭우	heavy rain
호우주의보	heavy rain warning
황사	yellow dust[sand], Asian dust
건조하다	dry (adj)
덥다	hot (adj)
따뜻하다	warm, hot, mild (adj)
무덥다	sweltering, humid, stifling (adj)
상쾌하다	fresh, refreshing (adj)
서늘하다	cool, chilly (adj)
선선하다	cool, refreshing (adj)
습하다	damp, moist, humid (adj)
시원하다	cool (adj)
쌀쌀하다	chilly (not 썰..)  (adj)
썰렁하다	chilly (not 쌀..)  (adj)
춥다	to be cold  (adj)
쾌적하다	pleasant, nice  (adj)
포근하다	cozy, warm, mild  (adj)
화창하다	clear, fine, bright, sunny  (adj)
후덥지근하다	sultry, stuffy, sticky (adj)
가을을 타다	get sentimental in the fall
봄을 타다	lose one’s appetite in the spring, get spring fever
구름이 끼다	it is (getting) cloudy
기온이 높다	high temperature
기온이 낮다	low temperature
기온이 뚝 떨어지다	(sudden) temperature drop (lit.: temperature dropped with a thud)
기온이 올라가다	temperature is rising
기온이 내려가다	temperature is droping
낙엽이 지다	leaves are falling from the trees
날씨가 맑다	sunny
날씨가 흐리다	cloudy
날씨가 변덕스럽다	unstable weather
날씨가 이상하다	weather is funny/weird
날이 저물다	day is getting darker
날이 풀리다	days are getting warmer/better
눈이 오다	snowing
단풍이 물들다	the maple leaves are colorful
단풍이 지다	the maple leaves are falling
대체로 맑겠다	generally clear weather
더위를 타다	be sensitive to heat
추위를 타다	be sensitive to cold
더위를 먹다	be affected by heat
바람이 불다	wind is blowing
번개가 치다	lightning strikes
부채질을 하다	(to use a) fan
불쾌지수가 높다	high discomfort
비 올 확률이 높다	high chance of rain
비 올 확률이 낮다	low chance of rain
비가 오다	raining
비가 그치다	rain stopped
비에 젖다	get rain-soaked
소나기가 내리다	it's showering (weather phenomenon)
손발이 꽁꽁 얼다	hands and feet are freezing [꽁꽁: 언 모양의 소리]
습도가 높다	high percentage of humidity
습도가 낮다	low percentage of humidity
안개가 끼다	fog, mist
옷차림에 신경을 쓰다	to mind about the attire
우산을 쓰다	put up an umbrella,use an umbrella
일교차가 크다	daily temperature range is big/growing
일기예보를 듣다	listen to the weather forecast
장마 지다	it is (summer) monsoon season
장마가 시작되다	the rainy season is coming
절정에 달하다	come to the climax, reach the zenith
점차 흐려지다	it is gradually getting cloudy (little by little)
찜통더위	sweltering [simmering] heat
천둥이 치다	thunder (thunder strikes)
태풍이 불다	typhoon is blowing
태풍이 지나가다	the typhoon passed (by), typhoon is done
푹푹 찌다	scorching (day)
해가 뜨다	the sun rises [comes up]
해가 지다	the sun sets [goes down, sinks]
*** 대중문화 - Pop culture (/course/634971/ebs-topik-ii-intermediateadvanced-vocabulary/29/)
감각적	sensible
보편적	universal
상업적	commercial
선정적	suggestive
오락적	entertaining
자극적	exciting, stimulating
제작자	maker, manufacturer
획일적	uniform, standardized
거듭나다	to reform, turn over a new leaf
깃들다	to be covered
내포하다	to involve
상징하다	to represent, symbolize
엿보다	to peep, peek
따분하다	dull, tedious, wearisome (adj)
지루하다	boring, bored, dull (adj)
감정을 해소시키다	Dissolve one´s feelings
고전을 면치 못하다	to struggle, have a tough time
꾸준한 관심을 불러일으키다	constantly raise interest
내용이 허술하다	lacking substance
냉담한 반응을 보이다	show a cold reaction (lack of interest)
노골적으로 표현하다	express oneself crudely, express openly
논란이 끊이지 않다	constant dispute
논란이 일어나다	dispute occurred
대리 만족을 느끼다	feel a vicarious satisfaction/thrill
대중의 행동 양식에 영향을 미치다	affects the behavior of the public
대중이 열광하다	public enthusiasm
동질감을 형성하다	mold the sense of kinship
뜨거운 반응을 얻다	get a hot response
무난한 반응을 이끌어내다	evoke a flat response
방송사 간에 시청률 경쟁을 심화하다	intensify the ratings' competition among broadcasters
방송시설이 열악하다	broadcasting system is inadequate/poor
사회 비판 의식을 대변하다	represent social criticism
사회상을 반영하다	reflect the realities of society
사회에 대한 비판의식을 보여주다	shows criticism on society
선풍적인 인기를 끌다	gain sensational popularity
설득력이 떨어지다	not very convincing
소재의 다양화가 필요하다	require the diversification of materials
여론을 조성하다	form public opinion
염증을 느끼다	feel dislike
외면을 당하다	to be disregarded
인기가 시들해지다	losing popularity
인위적으로 자극적인 상황을 설정하다	Artificially set up stimulating situations
지나치게 부각하다	Excessively relieved
큰 파장을 불러일으키다	kindle a huge uproar
큰 호응을 얻다	very well received
파급력이 크다	big effective power
폭발적인 반응을 이끌어내다	elicit an explosive response
폭발적인 인기를 누리다	enjoy a tremendous popularity
프로그램에 출연하다	appear on a show
*** 도시 - City (/course/634971/ebs-topik-ii-intermediateadvanced-vocabulary/30/)
계획도시	planned city
공업도시	industrial city (ㄱ)
관광도시	sightseeing city
교육도시	education city
도시 면적	urban area
도심	downtown, center of a city (시내)
비인간적	inhuman
산업도시	industrial city (ㅅ)
상하수도 시설	water and sewage
신도시	new town
주택 공급	supply of housing
첨단 의료 시설	high-tech medical equipment
편의 시설	amenities, accommodation
항구도시	port city
현대적	modern
휴양도시	resort city
단조롭다	to be monotonous
빽빽하다	to be dense, packed (가득하다 )
삭막하다	to be desolated
여유롭다	to be free
활기차다	to be lively
각종 소음 공해	various kinds of noise pollution
건설 계획이 추진되다	planned construction
고층 빌딩이 늘어서다	be lined with skyscrapers
공기가 탁하다	the air is thick/impure
교육 시설이 우수하다	education facilities are excellent
교통 체증에 시달리다	be pestered by traffic gridlock, stuck in traffic
녹지를 조성하다	create a green belt (zone)
대중교통이 편리하다	public transportation is convenient
도로망을 확충하다	expand the road network
문화적 혜택을 누리다	enjoy cultural benefits
복지 혜택이 다양하다	various welfare benefits
빽빽한 빌딩 숲을 이루다	the dense buildings form a “forest”
사회 기반 시설을 확충하다	expand social infrastructure
상점가가 밀집해 있다	shopping districts/centers are being concentrated
시내버스 노선을 정비하다	modify city bus routes
신속한 컴퓨터 통신망	speedy computer networks
여유로운 공간을 갖추다	prepare relaxing space
오염 방지 정책을 마련하다	create pollution control policies
위생적으로 폐기물을 처리하다	dispose waste in a sanitary way
인구 과잉 집중 현상	concentration of overpopulation phenomenon
인구 밀도가 높다	to be overpopulated
인구가 도시로 몰리다	urbanization of population
인구가 집중되다	the population is concentrated
인구의 집중을 억제하다	control of the population concentration
인파가 넘쳐나다	the crowd is overflowed
자동차 진입을 제한하다	restrict the entry of cars
주차 요금을 인상하다	increase parking fee
주차난으로 골치를 앓다	suffer from parking difficulties
주택 부족 현상이 심각하다	acute shortage of housing
치안 유지가 잘되다	peace preservation works very well (maintain security)
치안 유지에 힘쓰다	make an effort to maintain security
*** 동물 = Animals (/course/634971/ebs-topik-ii-intermediateadvanced-vocabulary/31/)
꼬리	tail
둥지	nest
먹잇감	prey
몸통	torso
무늬	pattern
생김새	appearance
수컷	male
암컷	female
이동하다	move
잡아먹다	prey on, feed on (catch and eat)
활동하다	be active
떼/무리를 지어 다니다	swarm, be in groups (ie move together in groups)
먹이를 발견하다	locate the prey
먹이를 잡다	catch the prey
먹이를 주다	feed (someone)
몸을 숨기다	hide the body
본능을 가지다	have instinct
새끼를 낳다	have babies
습성이 있다	have a habbit
알을 낳다	lay eggs
알을 품다	hatch eggs, sit on a nest of eggs
애벌레가 되다	become caterpillars
천적을 만나다	meet a predator (natural enemy)
*** 몸짓 - Gestures (/course/634971/ebs-topik-ii-intermediateadvanced-vocabulary/32/)
고개를 끄덕이다	nod one's head
고개를 숙이다	lower one's head
고개를 좌우로 흔들다	shake one's head (from) side to side
다리를 떨다	shake one's leg
두 손으로 바닥을 짚다	place two hands on the floor, touch the floor with 2 hands
두 손을 깍지 끼다	fold one's hands
두 손을 앞으로 모으다	place hands together in the front
무릎을 꿇다	kneel down
무릎을 세우다	draw up one's knees
미간을 찡그리다	frown
미소를 짓다	to smile
발을 쭉 뻗다	stretch one's feet
상체를 뒤로 젖히다	bend one's upper body backwards
손가락으로 가리키다	point with one's finger
손으로 얼굴을 가리키다	cover one’s face with one’s hands
손으로 턱을 괴다	rest one's chin in one's hand
양반 다리를 하다	cross legs
어깨를 으쓱 올리다	shrug the shoulders
어깨를 펴다	straighten up the shoulders
얼굴을 찡그리다	make grimaces
엄지 손가락을 세우다	do a thumbs-up
턱을 괴다	support jaw (with one's hands..)
팔을 구부리다	bend one's arm
팔짱을 끼다	cross one's arms
한쪽 다리를 뻗다	stretch legs
허리를 굽히다	bend the body
허리를 꼿꼿하게 펴다	stretch one's waist upstraight
*** 방송 - Broadcasting (/course/634971/ebs-topik-ii-intermediateadvanced-vocabulary/33/)
뉴스	news
다큐멘터리	documentary
드라마	drama
라디오 프로그램	radio program
스포츠 방송	sportscast
시사 프로그램	current affairs program
시청자	viewer
청취자	listener
어린이 프로그램	kid program
오락 프로그램	entertainment program
퀴즈 프로그램	quiz program
텔레비전 프로그램	television program
시청률이 높다	high viewer ratings
주파수를 맞추다	retune
화면이 끊기다	the scene was cut off
장면을 놓치다	miss scene
채널을 돌리다	change the channel
텔레비전을 시청하다	watch television
라디오를 듣다	listen to radio
신청곡을 받다	receive a song request
노래를 신청하다	request a song
사연을 보내다	send a story
볼륨을 올리다	raise volume
볼륨을 높이다	turn up volume
드라마에 나오다	appear in a drama
방송의 질을 떨어뜨리다	lower the quality of broadcasting
카메라를 설치하다	set the camera
*** 봉사 - Services (/course/634971/ebs-topik-ii-intermediateadvanced-vocabulary/34/)
결식아동	poorly-fed children
고아원	orphanage, home for orphans
기부액	amount of donation
기부자	a contributor, a donator, a donor
노숙자	homeless person
독거노인	senior citizen who lives alone
미혼모	single mother
보호자	guardian, protector
복지 제도	welfare system
불우이웃	unfortunate neighbors
사회복지센터	social welfare center
소년 소녀 가장	a child breadwinner
양로원	nursing home, old people's home
요양원	sanatorium, sanitarium
장애인	disabled person, handicapped
저소득층	lower-income group
기부하다	to donate, contribute (not ..증....)
기증하다	to donate, contribute (not ..부....)
돌보다	look after, take care of (not 뒷...)
지원하다	to support, aid
기특하다	admirable, praiseworthy, commendable (adj)
가치 있는 일을 위해 헌신하다	Committed to anything of value
개발 원조를 추진하다	Push ahead with its development assistance
경제적 지원을 하다	To financially aid/support
냉담한 시선을 보내다	Have an apathetic look
뒷바라지하다	look after, take care of (not 돌..)
말벗이 되다	keep someone company
병석에 눕다	be bedridden
사회적 편견을 없애다	eliminate social prejudice
서로에게 힘이 되어주다	give each other strength, (support each other)
원조를 받다	receive assistance
일손을 돕다	provide a helping hand
자원봉사를 하다	do volunteer work
정기적으로 봉사에 참여하다	regularly participate at serving help
타인과 더불어 살다	live together with others
후원금을 보내다	send private donation
후원을 받다	receive support, donation
*** 부탁 - Request, favor (/course/634971/ebs-topik-ii-intermediateadvanced-vocabulary/35/)
부탁드리다	to ask, to request
부탁하다	to request
곤란하다	tough, difficult
부담스럽다	uncomfortable, burdensome
어렵다	to be difficult
다른 게 아니라	nothing else
도와줄 수 있다/없다	can help / cannot help
도움이 되다	be of help to
부탁을 거절당하다	refuse favor
부탁을 들어주다/거절하다	do someone a favor / refuse a favor
부탁을 받다	be asked a favor
부탁이 있다	to have a request
*** 사건, 사고 - Accidents and incidents (/course/634971/ebs-topik-ii-intermediateadvanced-vocabulary/36/)
교통사고	car accident
도둑	thief
무단 횡단	jaywalking
부상자	injured, wounded
부실 공사	poor construction
뺑소니 차	hit and run
사고 대책	accident measures
사고 방지	accident prevention
사고 원인	cause of accident
사망자	dead
소매치기	pickpocket
소방차	fire truck
실종자	a missing person
음주 운전	drunk driving
응급 환자	emergency patient
응급실	emergency room (ER)
인명 피해	damage of human life
접촉 사고	minor collision, fender-bender
졸음 운전	drive while drowsy
피해자	victim
과속하다	speeding
구조하다	to rescue
도망가다	run away
목격하다	to witness
밝혀지다	to be/get revealed
부딪치다	to bump/hit against sth
사망하다	to pass away, die (not 죽.., not 숨....)
속다/속이다	be deceived, deceive someone
술주정하다	to be drunk
숨지다	to pass away, die (not 죽.., not 사.....)
신고하다	to report, register
실종되다	to disappear
전해지다	be told, be conveyed, be reported
죽다	1) die, perish 2) extinguish 3) lose power
진술하다	lay the case
추월하다	pass (another car), overtake
충돌하다	to collide with, crash into
침입하다	trespassing, infringement, to invade
신속하다	to be quick, swift, speedy (adj)
119에 신고하다	call/report to 119
가스가 폭발하다	gas explosion
건물이 무너지다	building collapsed (not 붕...)
건물이 붕괴되다	building collapsed (not 무...)
검은 연기가 나다	black smoke is rising
계단에서 구르다	fall down the stairs
긴급 출동하다	emergency rescue
길이 미끄럽다	slippery road (not 빗..)
난리가 나다	start a fuss
난장판이 되다	fall into utter confusion
넘어져서 다치다	trip and get hurt by the fall
도난 신고를 하다	report a theft
도둑을 맞다	be robbed
도둑이 들다	be robbed (burglary)
목숨을 구해주다	save someone's life
물에 빠지다	fall into the water
배가 침몰하다	ship is shinking
범인의 흔적을 발견하다	discover the tracks of a criminal
벼락을 맞다	be struck (dead) by lightning
별 다른 피해가 없다	no particular damage was done
병원으로 옮겨지다	rush/move to a hospital
병원에서 치료중이다	be under treatment at the hospital
불이 나다	a fire breaks out (not 화..)
불안감을 호소하다	complain about anxiety
불이 번지다	fire is spreading out
비행기가 추락하다	an airplane crashes
빗길에 미끄러지다	slippery/wet road
사고 신고를 받고 출동하다	to get mobilized after the report of an accident
사고가 나다/발생하다	an accident occurs/takes place
사고를 내다	to have an accident (not 당..)
사고를 당하다	to have an accident (not 내..)
생명에 지장이 없다	non-life threatening injuries
생명을 건지다	assurance of life, to make it out alive
소매치기를 당하다	have one's pocket picked
신호를 위반하다	violate a traffic light [signal]
엔진이 고장 나다	have some engine trouble
열차 운행이 중단되다	interrupt train service
운전하다가 깜빡 졸다	while I was driving I just dozzed off
유리창이 깨지다	the glass window got broken
재산 피해를 입다	suffer property damage
정신이 없다	be out of my mind
조사를 벌이다	conduct/start an investigation
중상을 입다	injure one's self seriously
중심을 잃고 쓰러지다	lose balance and fall
집 밖으로 탈출하다	escape from the building
차가 부서지다	car crash, car wreck
차량 통행을 막다	vehicle traffic
출입을 통제하다	forbid sb to enter or leave
충격을 받다	be shocked, traumatized (by)
테러가 발생하다	terror/terrorism occurs
화재가 발생하다	a fire breaks out (not 불..)
*** 사회, 정치 - Social, politics (/course/634971/ebs-topik-ii-intermediateadvanced-vocabulary/37/)
경제 협력	economic cooperation
공동체 의식	community spirit
복지예산	welfare budget
상부상조 정신	spirit of mutual cooperation
서열 의식	(be) aware of rank, grade consciousness
연고주의	nepotism, cronyism
재정 긴축	retrenchment in finance
재정 부담	financial burden
집단주의	collectivism
효사상	filial piety thoughts
시행되다	take effect
편성하다	to organize
폐지되다	be/get abolished, get out of use
협력하다	cooperate
갈등을 해소하다	resolve a conflict
강력한 규제가 필요하다	need stricter regulation
경제 수준이 높다	economy level is high
국가 경쟁력이 강화되다	enhance national competitiveness
국가 위상이 약화되다	weaken the country's international profile
국가 차원의 장기적 정책	long-term policy of the national level
국력이 향상되다	national power improved/advanced
국제적 책임과 의무가 커지다	international responsibility and duty (liability) is extended
규제 방안을 마련하다	come up with a set of regulations
급속한 경제 성장을 이루다	achieve rapid economic growth
난색을 표하다	express disapproval, to oppose
당국의 정책	an official policy
동질성을 회복하다	recovery of homogeneity
문화 교류를 확대하다	expand cultural exchange
법적으로 의무화하다	by legal responsibility (mandatory, pass law)
상호 신뢰를 회복하다	restore mutual trust
선거를 실시하다	hold an election
세계 평화를 위협하다	threaten world peace
시민 의식이 높다	citizenship consciousness is high
시위가 이어지다	to demonstrate
시행을 서두르다	hurry on (rush) enforcement
예산안을 발표하다	announce budget plan
외교적 노력에 힘쓰다	actively involved in diplomatic efforts
원칙에 위배되다	violates the principle
의식 수준이 높다	high level of consciousness
인도적 지원이 필요하다	humanitarian support is required
정권이 교체되다	regime (government) is replaced
정부를 수립하다	establish a government
조치를 취하다	take a measure
쿠데타를 일으키다	carry out a coup d’etat
협력과 교류가 활발해지다	cooperation and exchange are on a perk
회담을 하다	talk together, hold conversations
시위/항쟁이 일어나다	demonstration is taking place / uprising broke out
회원국으로 가입하다	become a state member
*** 사회 문제 - Social issues (/course/634971/ebs-topik-ii-intermediateadvanced-vocabulary/38/)
노인 문제	problems of the elders
노인 복지	welfare for the elders
다문화 가족	multicultural family
맞벌이 부부	a couple working together for a living
무자녀 가구	family without children
비행 청소년	juvenile delinquents
사고방식	one's way of thinking
사생활	private life
생활 방식	method of livelihood
시각 장애인	a person who is visually impaired
알코올 중독자	an alcoholic
우울증 환자	a melancholiac, hypochondriac
일인 가구	one person household
자선 단체	a social service organization, philanthropic institution
장애인	disabled person, handicapped
정신지체	mental retardation
혐의	suspicion, charge
간소화되다	to be simplified
금지하다	prohibit, ban, forbid
기부하다	to donate, contribute (not ..증....)
낭비하다	to waste, dissipate
의존하다	depend on, rely on
파산하다	to go bankrupt
화해시키다	to reconcile
바람직하다	desirable, advisable (adj)
사치스럽다	luxurious, extravagant  (adj)
심각하다	serious, grave, severe, critical (adj)
가족관이 변화하다	family values change
가치관이 다르다	different values
결혼을 미루다	postpone marriage
경향이 있다	tend to
고령화가 가속화되다	aging is accelerated
고부간의 갈등	daughter-in-law and mother-in-law conflicts
관심을 받다	to receive interest
국민연금에 가입하다	enroll for national pension
꾸준히 늘고 있다	steadily rising
남에게 피해를 주다	give damage to others
노동인구가 부족하다	insuficient labor manpower
노후가 안정되다	stable retirement
노후를 준비하다	prepare for one's retirement
맞벌이 부부가 늘어나다	double earning couples are increasing
미비한 노후 대비	inadequate retirement preparation
방법을 찾다	search for method,way
범행을 저지르다	commit a crime
법정에 서다	stand before the court
변화를 시도하다	attempt to change
보육시설이 부족하다	childcare facilities are lacking
불우이웃을 돕다	help unfortunate neighbors
불이익이 되다	become a disadvantage
불편을 겪다	experience inconvenience
사회 복지 제도를 확충하다	expanding the social welfare system
삶의 질을 개선하다	improve one's quality of life
새로운 일자리를 창출하다	create new jobs
생산인구가 감소하다	productive population is decreasing
성공 사례로 평가되다	rated/evaluated as a success story
세금 부담이 커지다	the tax burden is getting bigger
세대 차이가 나다	generation gap
수명을 연장하다	lengthen one's life
스트레스를 받다	to have stress
시선을 끌다	draw attention
양육비에 대한 부담이 크다	great burden of child support
어려운 이웃	needy neighbor
연령대가 낮아지다/높아지다	age group is getting lower/higher
영향을 미치다	have an effect on
외국인의 노동력을 활용하다	utilize foreign labor manpower
외로움을 느끼다	feel lonely
우울증을 예방하다	prevent depression
이혼율이 증가하다	divorce rate is growing
인기를 끌다	(attract) gain popularity
적극적인 관심이 필요하다	requires enthusiastic/active interest
정년을 연장하다	put off retirement
정서적으로 안정되다	be emotionally stable
조세 부담이 증가하다	tax burden is increasing
좋은 반응을 얻다	get a good response
지속적으로 경고하다	be constantly alert
지속적인 고용 불안	continuous job insecurity
처벌을 받다	receive punishment, be penalized
초혼 연령이 상승하다	age of first marriage is rising
출산율이 저조하다	birth rate is low
출산을 장려하다	encourage childbirth
취업난이 심각하다	serious unemployment crisis
평균 수명이 늘어나다	average life span is increasing
행복한 삶을 살다	live a happy life
화제가 되다	make the headlines, become a hot topic
확대하여 실시하다	extend conduct
*** 상품 소개 - Product introduction (/course/634971/ebs-topik-ii-intermediateadvanced-vocabulary/39/)
경향	tendency, trend, inclination
기능성	functionality
원단	fabric, material
부품	part, component
성능	performance (efficiency)
성인 고객층	adult audience
외형	shape, appearance, look
최신형	the latest model, latest, cutting-edge
캐릭터 상품	character product, products featuring popular comic characters
판매처	store, distributor
기술 특허를 받다	to patent (a product)
눅눅해지지 않다	does not become damp, soggy
변형이 적다	few modifications
세련된 느낌을 주다	give a sophisticated/polished/classy feeling
안정성이 뛰어나다	excellent stability
천연 소재	natural substance
첨단 기술을 도입하다	introduce advanced technology
출시하기로 하다	put a new product on the market (release, launch)
톡톡 튀는 아이디어	an idea that stands out, sparkling idea
흡습성이 좋다	good hygroscopic property, hygroscopicity (moisture absorption)
방습성이 좋다	damp-proof
*** 소개 - Introduction (/course/634971/ebs-topik-ii-intermediateadvanced-vocabulary/40/)
가족	family
국적	nationality
나이	age
동기	siblings; (motive)
새내기 성격	fresh personality
성별	sex, gender
신입사원	new employee
신입생	new student
신입회원	new member
연락처	contact info (ie phone etc)
이름	name
이상형	ideal type
장래 희망	prospect wish/desire
장점/단점	strong points/weak points
전공	one's major, specialty
직업	job
취미	hobby
특기	one's special ability [talent,gift, skill]
학번	when one was admitted to school
호칭	one's title
별명	nickname
소개하다	to introduce
입사하다	to join a company
입학하다	admission into school
함께하다	to share, do sth together
낯설다	unfamiliar (adj)
반갑다	glad, happy, pleasant, welcome (adj)
서툴다	clumsy (adj)
친근하다	close, familiar (adj)
말을 걸다	initiate (start up) a conversation
새로 오다	new one coming
순서대로 자기소개를 하다	introduce one's self in order
앞으로 잘 부탁하다	"please take care of me from now on"
친구를 사귀다	make friends
*** 성격 - Personality (/course/634971/ebs-topik-ii-intermediateadvanced-vocabulary/41/)
가정적	family-oriented
감성적	emotional
개성적	personal, original
긍정적	positive, affirmative
낙관적	optimistic, positive, sanguine
내성적	introverted
논리적	logical
보수적	conservative
부정적	negative, pessimistic
비관적	pessimistic, gloomy, discouraged
비판적	critical
사교적	sociable, outgoing
소극적	passive, half-hearted
순종적	obedient
외향적	extroverted, outgoing
이기적	self-centered, selfish, egoistic (not 자..)
이성적	rational, reasonable
자기중심적	self-centered, selfish, egoistic (not 이..)
적극적	active, aggressive, enthusiastic
직선적	straightforward, forthright, outspoken (not ㅅ...)
진취적	adventurous, enterprising, forward-looking
창의적	creative, original, inventive, ingenious
현실적	realistic, practical, down-to-earth
활동적	active, energetic
희생적	giving
덤벙대다	act frivolously (verb)
검소하다	frugal, thrifty
게으르다	lazy, idle
까다롭다	particular, fussy, picky, choosy
깔끔하다	neat and efficient
꼼꼼하다	meticulous, precise, detailed
꾸준하다	steady, constant, consistent, tireless, untiring
냉정하다	cold, cold-hearted
단순하다	simple, naive
대범하다	broad-minded, big-minded, generous, bold
덜렁거리다	be careless, be clumsy
똑똑하다	smart, clever, bright, intelligent
매섭다	fierce, sharp, harsh
명랑하다	cheerful, cheery
무뚝뚝하다	abrupt, unfriendly, cold
변덕스럽다	unpredictable, capricious, fickle, temperamental
부지런하다	hard-working, diligent
사치스럽다	luxurious, extravagant  (adj)
산만하다	distracted, unfocused
성실하다	sincere, earnest
불성실하다	untrustworthy
소심하다	timid
시원시원하다	straightforward, outspoken (not ㅈ)
알뜰하다	(돈을) 아껴 쓰다
얌전하다	gentle, well-behaved, well-mannered
어른스럽다	mature (성숙하다)
엄하다	strict, stern, rigid
예민하다	keen, acute, sensitive
용감하다	brave, courageous
우유부단하다	indecisive, irresolute
유치하다	childish, immature
인색하다	miserly, cheap, mean
자상하다	thoughtful, considerate, attentive
점잖다	gentle, decent, respectable
조용하다	to be quiet
진지하다	serious, earnest, sober
차분하다	calm, cool, relaxed
친절하다	kind, friendly
쾌활하다	cheerful, lively, cheery, merry, jolly, bubbly
털털하다	easy-going
현명하다	wise, sensible, sagacious
활발하다	animated, brisk
결단력이 있다	be decisive
고집이 세다	be stubborn
공사구분이 확실하다	distinction between public and private matters is clear
끈기/인내심이 있다	patient, can endure
낭비가 심하다	to waste a lot
내숭을 떨다	be really shy (shiver in coy)
눈치가 빠르다	be quick-witted
대인 관계가 원만하다	good relationship with others
도전 정신이 강하다	has strong mental challenge
리더십이 있다	has leadership
말을 잘 못 걸다	not good at talking
말이 없다	not talkative
매사에 신중하다	be cautious, very careful about everything
배짱이 좋다	got nerve, to be bold
사람들과 잘 어울리다	fits in well with others
사람이 좋다	be good natured
성격이 급하다	be impatient, hasty
성격이 느긋하다	easygoing personality
성격이 밝다	bright personality
성격이 어둡다	dark personality
성격이 원만하다	amicable personality
싫증을 잘 내다	get fed up easily
씀씀이가 헤프다	waste money, big spender, spend money freely
씀씀이가 크다	spend money liberally
아이 같다	like a baby
욕심이 많다	greedy
유머감각이 있다	has sense of humor
융통성이없다	be unadaptable, non flexible
인간미가 넘치다	overflows with humanity/warmth
인간성이 좋다	nice personality (lit. nice human quality)
인내심이 많다	has a lot of patience
인정이 없다	be cold-hearted, heartless, merciless, unsympathetic
인정이 많다	warmhearted, "man of gold"
일 처리가 꼼꼼하다	handles things meticulously
입이 가볍다	be talkative, bigmouth
입이 싸다	have a big mouth
자기밖에 모르다	only cares about himself
자기주장이 강하다	be self-assertive
자기표현을 잘 하지 못하다	cannot express well about one's self
자존심이 강하다	very proud person, one who thinks highly of himself
자주 깜빡하다	often forgets
장난이 심하다	mischievous
책임감이 강하다	has a strong sense of responsibility
호기심이 많다	curious
*** 쇼핑 - Shopping (/course/634971/ebs-topik-ii-intermediateadvanced-vocabulary/42/)
거스름돈	change
계산대	counter, checkout
고가품	high-priced article
구멍가게	small store
단골손님	a regular (customer)
대형 할인 매장	cash and carry, large discount store
디자인	design
면세점	Duty Free Shop
명품	luxury item, masterpiece, masterwork
바겐세일	bargain sale
배송비	delivery charge[fee], shipping and handling charge
백화점	department store
비닐봉지	plastic bag
상설 할인 매장	discount store, outlet
상품권	gift card, voucher
새깔	color
세일/할인	sale, discount
소비자	consumer
손님	guest, visitor, company (not ㄱ )
고객	customer, guest (not ㅅ)
쇼윈도	display window, show window
쇼핑몰	shopping mall
쇼핑백	shopping bag
스타일	style
시장	market
신상품	new product (not ...제..)
신제품	new product (not ...상...)
유명 브랜드	a famous brand
인기 상품	a popular (hot) item
인터넷 쇼핑	internet shopping
장바구니	shopping basket
재고품	goods in stock [a storehouse], stored goods
적립 카드	saving card (accumulated card)
적립금	saved money, accumulated money
점원	clerk, shop assistant
정가	fixed price
정찰제	fixed-price system, price-tag system
제조일자	date of manufacture
제품	product, goods
종업원	employee, worker
종이봉투	paper bag
중고품 가게	secondhand shop, charity shop
진열장	showcase, display case
착용감	sensation of wearing sth
최신 유행	the latest fashion
카운터	counter
크기/사이즈	size
탈의실	fitting room, changing/dressing room
편의점	convenience store
할인 카드	discount card
할인 쿠폰	discount coupon
할인 판매	discount sale
홈쇼핑	home shopping
결제하다	pay for, charge (credit card)
계산하다	calculate, compute, balance
고르다	chose, pick
구매하다	purchase, make a purchase (not ..입....)
구입하다	purchase, make a purchase (not ..매....)
권하다	advise, suggest, recommend, offer
낭비하다	to waste, dissipate
돌아다니다	get around, go around, wander
배달하다	make a delivery, deliver
배송하다	ship, deliver
입어보다	try sth on
절약하다	아끼다
주문하다	to order
지불하다	make a payment
진열되다	be on display
추천하다	recommend
판매하다	to sell
팔리다	매진되다
포장하다	to pack, wrap up
품절되다	run[be] out of stock, be sold out
고급스렵다	high class (adj)
다양하다	various, varied, diverse, different (adj)
만족스럽다	satisfactory, gratifying, acceptable (adj)
유행하다	be in fashion, be popular (adj)
저렴하다	cheap, inexpensive (adj)
참신하다	original, fresh, novel (adj)
특이하다	unusual, interesting, unique (adj)
편하다	comfortable, relaxed, easy (adj)
가격을 흥정하다	bargain with sb over the price (of)
값을 깎다	reduce a price
계산기를 두드리다	work[tap] on a calculator
다음에 또 오세요	please come again
돈을 거슬러 주다	give back money
디자인이 단순하다	simple design
딱 맞다	fit perfectly
마음에 들다	be to one´s liking (자신의 느낌이나 생각과 같아서 좋다)
뭘 드릴까요?	What can I do for you? / How may I help you?
바가지를 씌우다	overcharge (rip off someone)
쇼핑하기 편리하다	shopping is convenient
어떤 것을 찾으세요?	what are you looking for?
어서 오세요	Come right it in please (welcome)
얼마예요?	How much is it?
여기 있어요	Here it is (there you go)
잘 나가다	to come out good (to be in demand)
잘 어울리다	to fit well
정성이 담기다	to be filled with love
주문량이 많다	large amount of orders
치수가 어떻게 되세요?	what is your size?
카드에 적립하다	accumulated on card
택배로 주문하다	order by courier service
품질이 좋다	good quality
한 벌로 되다	to be a set / pair
